"aa" = (/turf/open/space,/area/space)
"ab" = (/turf/closed/wall/r_wall,/area/shuttle/ftl/munitions/cannon)
"ac" = (/turf/closed/wall/r_wall,/area/shuttle/ftl/medical/medbay)
"ad" = (/turf/closed/wall/r_wall,/area/shuttle/ftl/security/armory)
"ae" = (/turf/closed/wall/r_wall,/area/shuttle/ftl/engine/engineering)
"af" = (/obj/structure/shuttle/engine/propulsion{dir = 8; icon_state = "propulsion"},/turf/open/space,/area/space)
"ag" = (/obj/machinery/door/poddoor/preopen{id = "bridge blast"; layer = 2.9; name = "bridge blast door"},/turf/open/floor/plating/airless,/area/shuttle/ftl/munitions/cannon)
"ah" = (/obj/machinery/power/shipweapon{anchored = 1; dir = 8; state = 2},/obj/structure/cable{icon_state = "0-4"; d2 = 4},/turf/open/floor/plating/airless,/area/shuttle/ftl/munitions/cannon)
"ai" = (/obj/structure/cable{d1 = 4; d2 = 8; icon_state = "4-8"; pixel_x = 0},/obj/machinery/door/airlock/glass_external,/turf/open/floor/plating/airless,/area/shuttle/ftl/munitions/cannon)
"aj" = (/obj/structure/cable{d1 = 4; d2 = 8; icon_state = "4-8"; pixel_x = 0},/turf/open/floor/plating/airless,/area/shuttle/ftl/munitions/cannon)
"ak" = (/obj/structure/cable{d1 = 4; d2 = 8; icon_state = "4-8"; pixel_x = 0},/obj/machinery/door/airlock/glass_external,/turf/open/floor/plasteel{icon_state = "dark"},/area/shuttle/ftl/munitions/cannon)
"al" = (/obj/structure/cable{d1 = 2; d2 = 8; icon_state = "2-8"; tag = ""},/turf/open/floor/plasteel/whiteblue/side{tag = "icon-whiteblue (NORTHWEST)"; icon_state = "whiteblue"; dir = 9},/area/shuttle/ftl/medical/medbay)
"am" = (/obj/machinery/atmospherics/components/unary/vent_scrubber,/turf/open/floor/plasteel/whiteblue/side{tag = "icon-whiteblue (NORTH)"; icon_state = "whiteblue"; dir = 1},/area/shuttle/ftl/medical/medbay)
"an" = (/turf/open/floor/plasteel/whiteblue/side{tag = "icon-whiteblue (NORTH)"; icon_state = "whiteblue"; dir = 1},/area/shuttle/ftl/medical/medbay)
"ao" = (/turf/open/floor/plasteel/whiteblue/side{tag = "icon-whiteblue (NORTHEAST)"; icon_state = "whiteblue"; dir = 5},/area/shuttle/ftl/medical/medbay)
"ap" = (/turf/open/floor/plasteel/darkred,/area/shuttle/ftl/security/armory)
"aq" = (/obj/structure/closet/secure_closet/armory2,/turf/open/floor/plasteel/darkred,/area/shuttle/ftl/security/armory)
"ar" = (/turf/open/floor/engine,/area/shuttle/ftl/engine/engineering)
"as" = (/turf/closed/wall/r_wall,/area/shuttle/ftl/bridge)
"at" = (/obj/structure/grille,/obj/structure/window/reinforced/fulltile,/obj/machinery/door/poddoor/preopen{id = "bridge blast"; layer = 2.9; name = "bridge blast door"},/obj/structure/cable{d1 = 1; d2 = 2; icon_state = "1-2"},/turf/open/floor/plating,/area/shuttle/ftl/bridge)
"au" = (/obj/structure/cable{d1 = 1; d2 = 2; icon_state = "1-2"; pixel_y = 0},/turf/open/floor/plasteel/whiteblue/side{tag = "icon-whiteblue (WEST)"; icon_state = "whiteblue"; dir = 8},/area/shuttle/ftl/medical/medbay)
"av" = (/obj/machinery/atmospherics/pipe/simple/scrubbers/hidden,/turf/open/floor/plasteel/white,/area/shuttle/ftl/medical/medbay)
"aw" = (/turf/open/floor/plasteel/white,/area/shuttle/ftl/medical/medbay)
"ax" = (/obj/machinery/atmospherics/components/unary/vent_pump,/turf/open/floor/plasteel/white,/area/shuttle/ftl/medical/medbay)
"ay" = (/turf/open/floor/plasteel/whiteblue/side{tag = "icon-whiteblue (EAST)"; icon_state = "whiteblue"; dir = 4},/area/shuttle/ftl/medical/medbay)
"az" = (/obj/structure/grille,/obj/structure/window/reinforced/fulltile,/obj/machinery/door/poddoor/preopen{id = "bridge blast"; layer = 2.9; name = "bridge blast door"},/obj/structure/cable{d1 = 1; d2 = 2; icon_state = "1-2"},/obj/structure/cable{d1 = 1; d2 = 8; icon_state = "1-8"},/turf/open/floor/plating,/area/shuttle/ftl/bridge)
"aA" = (/obj/machinery/computer/ftl_weapons,/turf/open/floor/plasteel/darkred,/area/shuttle/ftl/bridge)
"aB" = (/turf/open/floor/plasteel/darkred,/area/shuttle/ftl/bridge)
"aC" = (/obj/machinery/computer/communications,/turf/open/floor/plasteel/darkred,/area/shuttle/ftl/bridge)
"aD" = (/obj/structure/cable{d1 = 1; d2 = 2; icon_state = "1-2"; pixel_y = 0},/turf/open/floor/plasteel/whiteblue/side{tag = "icon-whiteblue (SOUTHWEST)"; icon_state = "whiteblue"; dir = 10},/area/shuttle/ftl/medical/medbay)
"aE" = (/obj/machinery/atmospherics/pipe/simple/scrubbers/hidden,/turf/open/floor/plasteel/whiteblue/side,/area/shuttle/ftl/medical/medbay)
"aF" = (/turf/open/floor/plasteel/whiteblue/side,/area/shuttle/ftl/medical/medbay)
"aG" = (/obj/machinery/atmospherics/pipe/simple/supply/hidden,/turf/open/floor/plasteel/whiteblue/side,/area/shuttle/ftl/medical/medbay)
"aH" = (/turf/open/floor/plasteel/whiteblue/side{tag = "icon-whiteblue (SOUTHEAST)"; icon_state = "whiteblue"; dir = 6},/area/shuttle/ftl/medical/medbay)
"aI" = (/obj/machinery/door/airlock/glass_security,/turf/open/floor/plasteel/darkred,/area/shuttle/ftl/security/armory)
"aJ" = (/obj/machinery/ftl_shieldgen,/turf/open/floor/engine,/area/shuttle/ftl/engine/engineering)
"aK" = (/obj/machinery/ftl_drive,/turf/open/floor/engine,/area/shuttle/ftl/engine/engineering)
"aL" = (/obj/machinery/computer/ftl_navigation,/turf/open/floor/plasteel/darkred,/area/shuttle/ftl/bridge)
"aM" = (/obj/machinery/atmospherics/components/unary/vent_pump{dir = 4; external_pressure_bound = 140; on = 1; pressure_checks = 0},/turf/open/floor/plasteel/darkred,/area/shuttle/ftl/bridge)
"aN" = (/obj/structure/cable{d1 = 2; d2 = 4; icon_state = "2-4"},/obj/machinery/atmospherics/pipe/simple/supply/hidden{tag = "icon-intact (WEST)"; icon_state = "intact"; dir = 8},/turf/open/floor/plasteel/darkred,/area/shuttle/ftl/bridge)
"aO" = (/obj/structure/cable{d1 = 4; d2 = 8; icon_state = "4-8"; pixel_x = 0},/obj/machinery/atmospherics/pipe/simple/supply/hidden{tag = "icon-intact (WEST)"; icon_state = "intact"; dir = 8},/obj/machinery/door/airlock/glass_command{name = "Bridge"; req_access_txt = "19"},/turf/open/floor/plasteel,/area/shuttle/ftl/bridge)
"aP" = (/obj/structure/cable{d1 = 4; d2 = 8; icon_state = "4-8"; pixel_x = 0},/obj/structure/cable{d1 = 1; d2 = 4; icon_state = "1-4"},/obj/structure/cable{d1 = 2; d2 = 4; icon_state = "2-4"},/obj/machinery/atmospherics/pipe/manifold/supply/hidden{dir = 1},/turf/open/floor/plasteel,/area/shuttle/ftl/medical/medbay)
"aQ" = (/obj/structure/cable{d1 = 4; d2 = 8; icon_state = "4-8"; pixel_x = 0},/obj/machinery/atmospherics/pipe/simple/supply/hidden{tag = "icon-intact (WEST)"; icon_state = "intact"; dir = 8},/obj/machinery/atmospherics/pipe/simple/scrubbers/hidden,/turf/open/floor/plasteel,/area/shuttle/ftl/medical/medbay)
"aR" = (/obj/structure/cable{d1 = 4; d2 = 8; icon_state = "4-8"; pixel_x = 0},/obj/machinery/atmospherics/pipe/simple/supply/hidden{tag = "icon-intact (WEST)"; icon_state = "intact"; dir = 8},/turf/open/floor/plasteel,/area/shuttle/ftl/medical/medbay)
"aS" = (/obj/structure/cable{d1 = 4; d2 = 8; icon_state = "4-8"; pixel_x = 0},/obj/structure/cable{icon_state = "0-4"; d2 = 4},/obj/machinery/atmospherics/pipe/simple/supply/hidden{tag = "icon-intact (WEST)"; icon_state = "intact"; dir = 8},/turf/open/floor/plasteel,/area/shuttle/ftl/medical/medbay)
"aT" = (/obj/structure/cable{d1 = 4; d2 = 8; icon_state = "4-8"; pixel_x = 0},/obj/machinery/atmospherics/pipe/manifold/supply/hidden,/turf/open/floor/plasteel,/area/shuttle/ftl/medical/medbay)
"aU" = (/obj/structure/cable{d1 = 2; d2 = 4; icon_state = "2-4"},/obj/structure/cable{d1 = 2; d2 = 8; icon_state = "2-8"; tag = ""},/obj/machinery/atmospherics/pipe/manifold/supply/hidden{dir = 1},/turf/open/floor/plasteel,/area/shuttle/ftl/medical/medbay)
"aV" = (/obj/structure/cable{d1 = 4; d2 = 8; icon_state = "4-8"; pixel_x = 0},/obj/machinery/atmospherics/pipe/simple/supply/hidden{tag = "icon-intact (WEST)"; icon_state = "intact"; dir = 8},/obj/machinery/door/airlock/glass_engineering{name = "Engineering"; req_access_txt = "32"},/turf/open/floor/plasteel,/area/space)
"aW" = (/obj/structure/cable{d1 = 4; d2 = 8; icon_state = "4-8"; pixel_x = 0},/obj/machinery/atmospherics/pipe/simple/supply/hidden{tag = "icon-intact (WEST)"; icon_state = "intact"; dir = 8},/turf/open/floor/plasteel,/area/shuttle/ftl/engine/engineering)
"aX" = (/obj/structure/cable{d1 = 4; d2 = 8; icon_state = "4-8"; pixel_x = 0},/obj/structure/cable{d1 = 2; d2 = 8; icon_state = "2-8"; tag = ""},/obj/machinery/atmospherics/pipe/simple/supply/hidden{tag = "icon-intact (WEST)"; icon_state = "intact"; dir = 8},/turf/open/floor/plasteel,/area/shuttle/ftl/engine/engineering)
"aY" = (/obj/structure/cable{d1 = 4; d2 = 8; icon_state = "4-8"; pixel_x = 0},/obj/structure/cable{d2 = 8; icon_state = "0-8"},/obj/machinery/atmospherics/pipe/simple/supply/hidden{tag = "icon-intact (WEST)"; icon_state = "intact"; dir = 8},/obj/machinery/atmospherics/components/binary/valve/digital,/turf/open/floor/plasteel,/area/shuttle/ftl/engine/engineering)
"aZ" = (/obj/structure/cable{d1 = 4; d2 = 8; icon_state = "4-8"; pixel_x = 0},/obj/machinery/atmospherics/pipe/manifold/supply/hidden{dir = 1},/turf/open/floor/plasteel,/area/shuttle/ftl/engine/engineering)
"ba" = (/obj/structure/cable{d1 = 4; d2 = 8; icon_state = "4-8"; pixel_x = 0},/obj/machinery/atmospherics/pipe/simple/supply/hidden{dir = 4},/obj/machinery/atmospherics/components/unary/vent_scrubber,/turf/open/floor/plasteel,/area/shuttle/ftl/engine/engineering)
"bb" = (/obj/structure/cable{d1 = 4; d2 = 8; icon_state = "4-8"; pixel_x = 0},/obj/machinery/atmospherics/pipe/simple/supply/hidden{dir = 4},/turf/open/floor/plasteel,/area/shuttle/ftl/engine/engineering)
"bc" = (/obj/structure/cable{d2 = 8; icon_state = "0-8"},/obj/machinery/atmospherics/components/binary/valve/digital,/obj/machinery/atmospherics/pipe/simple/supply/hidden{dir = 4},/turf/open/floor/plasteel,/area/shuttle/ftl/engine/engineering)
"bd" = (/obj/machinery/atmospherics/components/unary/vent_pump{dir = 8; external_pressure_bound = 0; frequency = 1441; id_tag = "tox_out"; initialize_directions = 1; internal_pressure_bound = 4000; on = 1; pressure_checks = 2; pump_direction = 0},/turf/open/floor/plasteel,/area/shuttle/ftl/engine/engineering)
"be" = (/obj/structure/grille,/obj/structure/window/reinforced/fulltile,/obj/machinery/door/poddoor/preopen{id = "bridge blast"; layer = 2.9; name = "bridge blast door"},/obj/structure/cable{d1 = 1; d2 = 2; icon_state = "1-2"},/obj/structure/cable{d1 = 2; d2 = 8; icon_state = "2-8"; tag = ""},/turf/open/floor/plating,/area/shuttle/ftl/bridge)
"bf" = (/obj/machinery/computer/ftl_scanner,/turf/open/floor/plasteel/darkred,/area/shuttle/ftl/bridge)
"bg" = (/obj/structure/cable,/obj/machinery/atmospherics/components/unary/vent_scrubber{dir = 4; on = 1; scrub_N2O = 0; scrub_Toxins = 0},/turf/open/floor/plasteel/darkred,/area/shuttle/ftl/bridge)
"bh" = (/obj/machinery/atmospherics/pipe/simple/scrubbers/hidden{dir = 4},/turf/closed/wall/r_wall,/area/shuttle/ftl/bridge)
"bi" = (/obj/structure/cable{d1 = 1; d2 = 2; icon_state = "1-2"; pixel_y = 0},/obj/machinery/atmospherics/pipe/simple/supply/hidden,/obj/machinery/atmospherics/pipe/simple/scrubbers/hidden{dir = 4},/obj/machinery/door/airlock/glass_security,/turf/open/floor/plasteel,/area/shuttle/ftl/munitions/loading)
"bj" = (/obj/machinery/atmospherics/pipe/manifold/scrubbers/hidden,/turf/closed/wall/r_wall,/area/shuttle/ftl/munitions/loading)
"bk" = (/obj/machinery/atmospherics/pipe/simple/scrubbers/hidden{dir = 4},/turf/closed/wall/r_wall,/area/shuttle/ftl/munitions/loading)
"bl" = (/obj/machinery/atmospherics/pipe/manifold/scrubbers/hidden{dir = 1},/turf/closed/wall/r_wall,/area/shuttle/ftl/munitions/loading)
"bm" = (/obj/machinery/atmospherics/pipe/simple/scrubbers/hidden{dir = 4},/turf/closed/wall/r_wall,/area/shuttle/ftl/engine/engine_smes)
"bn" = (/obj/machinery/atmospherics/pipe/manifold/scrubbers/hidden{dir = 1},/turf/closed/wall/r_wall,/area/shuttle/ftl/engine/engine_smes)
"bo" = (/obj/structure/cable{d1 = 1; d2 = 2; icon_state = "1-2"; pixel_y = 0},/obj/machinery/atmospherics/pipe/simple/supply/hidden,/obj/machinery/atmospherics/pipe/simple/scrubbers/hidden{dir = 4},/obj/machinery/door/airlock/glass_engineering{name = "Power Storage"; req_access_txt = "11"; req_one_access_txt = "0"},/turf/open/floor/plasteel,/area/shuttle/ftl/engine/engine_smes)
"bp" = (/obj/machinery/atmospherics/pipe/simple/scrubbers/hidden{dir = 4},/obj/machinery/atmospherics/components/trinary/filter{dir = 4; filter_type = "o2"; req_access = null},/turf/open/floor/plasteel,/area/shuttle/ftl/engine/engineering)
"bq" = (/obj/structure/cable,/obj/machinery/atmospherics/components/trinary/filter{dir = 4; filter_type = "n2"; req_access = null},/turf/open/floor/plasteel,/area/shuttle/ftl/engine/engineering)
"br" = (/obj/machinery/atmospherics/pipe/simple/yellow/visible,/obj/machinery/atmospherics/pipe/simple/scrubbers/hidden{dir = 4},/turf/open/floor/plasteel,/area/shuttle/ftl/engine/engineering)
"bs" = (/obj/machinery/atmospherics/pipe/simple/supply/hidden,/obj/machinery/atmospherics/pipe/simple/scrubbers/hidden{dir = 4},/turf/open/floor/plasteel,/area/shuttle/ftl/engine/engineering)
"bt" = (/obj/machinery/atmospherics/pipe/manifold/scrubbers/hidden,/turf/open/floor/plasteel,/area/shuttle/ftl/engine/engineering)
"bu" = (/obj/machinery/atmospherics/pipe/simple/scrubbers/hidden{dir = 4},/turf/open/floor/plasteel,/area/shuttle/ftl/engine/engineering)
"bv" = (/obj/machinery/atmospherics/pipe/simple/scrubbers/hidden{dir = 10},/turf/open/floor/plasteel,/area/shuttle/ftl/engine/engineering)
"bw" = (/obj/structure/shuttle/engine/propulsion{dir = 8; icon_state = "propulsion"},/turf/open/space,/area/shuttle/ftl/atmos)
"bx" = (/obj/structure/cable{d1 = 1; d2 = 2; icon_state = "1-2"; pixel_y = 0},/obj/structure/cable,/obj/machinery/atmospherics/pipe/simple/supply/hidden,/turf/open/floor/plasteel,/area/shuttle/ftl/munitions/loading)
"by" = (/obj/structure/torpedo,/turf/open/floor/plasteel{icon_state = "bot"},/area/shuttle/ftl/munitions/loading)
"bz" = (/obj/structure/torpedo,/obj/machinery/atmospherics/pipe/simple/scrubbers/hidden,/turf/open/floor/plasteel{icon_state = "bot"},/area/shuttle/ftl/munitions/loading)
"bA" = (/turf/closed/wall/r_wall,/area/shuttle/ftl/engine/engine_smes)
"bB" = (/obj/machinery/power/port_gen/pacman/super,/obj/structure/cable/yellow{icon_state = "0-2"; d2 = 2},/obj/machinery/atmospherics/pipe/simple/scrubbers/hidden,/turf/open/floor/plasteel,/area/shuttle/ftl/engine/engine_smes)
"bC" = (/obj/machinery/power/port_gen/pacman/super,/obj/structure/cable/yellow{icon_state = "0-2"; d2 = 2},/turf/open/floor/plasteel,/area/shuttle/ftl/engine/engine_smes)
"bD" = (/obj/machinery/power/terminal{dir = 4},/obj/structure/cable{d1 = 1; d2 = 4; icon_state = "1-4"},/obj/structure/cable/yellow{icon_state = "0-2"; d2 = 2},/obj/machinery/atmospherics/pipe/simple/supply/hidden,/turf/open/floor/plasteel,/area/shuttle/ftl/engine/engine_smes)
"bE" = (/obj/machinery/power/smes,/obj/structure/cable{d2 = 8; icon_state = "0-8"},/obj/structure/cable{d1 = 2; d2 = 8; icon_state = "2-8"; tag = ""},/turf/open/floor/plasteel,/area/shuttle/ftl/engine/engine_smes)
"bF" = (/obj/machinery/atmospherics/pipe/simple/cyan/visible{icon_state = "intact"; dir = 5},/turf/closed/wall/r_wall,/area/shuttle/ftl/engine/engineering)
"bG" = (/obj/machinery/atmospherics/pipe/manifold/cyan/visible{dir = 4; initialize_directions = 11},/turf/open/floor/plasteel,/area/shuttle/ftl/engine/engineering)
"bH" = (/obj/machinery/atmospherics/pipe/simple/yellow/visible{dir = 5},/turf/open/floor/plasteel,/area/shuttle/ftl/engine/engineering)
"bI" = (/obj/machinery/atmospherics/pipe/simple/supply/hidden,/obj/machinery/atmospherics/pipe/simple/yellow/visible{dir = 4},/turf/open/floor/plasteel,/area/shuttle/ftl/engine/engineering)
"bJ" = (/obj/machinery/atmospherics/pipe/simple/yellow/visible{dir = 4},/turf/open/floor/plasteel,/area/shuttle/ftl/engine/engineering)
"bK" = (/obj/machinery/atmospherics/pipe/manifold/yellow/visible{dir = 4},/turf/open/floor/plasteel,/area/shuttle/ftl/engine/engineering)
"bL" = (/obj/machinery/atmospherics/pipe/simple/scrubbers/hidden,/turf/open/floor/plasteel,/area/shuttle/ftl/engine/engineering)
"bM" = (/turf/closed/wall/r_wall,/area/shuttle/ftl/munitions/loading)
"bN" = (/turf/open/floor/plasteel,/area/shuttle/ftl/munitions/loading)
"bO" = (/obj/machinery/atmospherics/components/unary/vent_pump{dir = 4; external_pressure_bound = 140; on = 1; pressure_checks = 0},/turf/open/floor/plasteel,/area/shuttle/ftl/munitions/loading)
"bP" = (/obj/machinery/atmospherics/pipe/simple/supply/hidden{dir = 4},/turf/open/floor/plasteel,/area/shuttle/ftl/munitions/loading)
"bQ" = (/obj/structure/cable{d1 = 1; d2 = 2; icon_state = "1-2"; pixel_y = 0},/obj/machinery/atmospherics/pipe/simple/supply/hidden{dir = 9; pixel_y = 0},/turf/open/floor/plasteel,/area/shuttle/ftl/munitions/loading)
"bR" = (/obj/structure/cable/yellow{d1 = 2; d2 = 4; icon_state = "2-4"},/obj/structure/cable/yellow{d1 = 1; d2 = 4; icon_state = "1-4"; tag = ""},/obj/machinery/atmospherics/components/unary/vent_scrubber{dir = 1; on = 1},/turf/open/floor/plasteel,/area/shuttle/ftl/engine/engine_smes)
"bS" = (/obj/structure/cable/yellow{d1 = 4; d2 = 8; icon_state = "4-8"},/obj/structure/cable/yellow{d1 = 1; d2 = 4; icon_state = "1-4"; tag = ""},/obj/structure/cable/yellow{d1 = 2; d2 = 4; icon_state = "2-4"},/turf/open/floor/plasteel,/area/shuttle/ftl/engine/engine_smes)
"bT" = (/obj/machinery/power/terminal{dir = 4},/obj/structure/cable/yellow{d1 = 2; d2 = 8; icon_state = "2-8"},/obj/structure/cable/yellow{d1 = 1; d2 = 8; icon_state = "1-8"},/obj/structure/cable/yellow{d2 = 8; dir = 8; icon_state = "0-8"},/obj/machinery/atmospherics/pipe/simple/supply/hidden,/turf/open/floor/plasteel,/area/shuttle/ftl/engine/engine_smes)
"bU" = (/obj/machinery/power/smes,/obj/structure/cable,/obj/structure/cable{tag = "icon-1-2"; icon_state = "1-2"},/turf/open/floor/plasteel,/area/shuttle/ftl/engine/engine_smes)
"bV" = (/obj/machinery/meter{name = "Mixed Air Tank In"},/obj/structure/window/reinforced,/obj/machinery/atmospherics/pipe/simple/cyan/visible,/turf/open/floor/plasteel,/area/shuttle/ftl/engine/engineering)
"bW" = (/obj/structure/window/reinforced,/obj/machinery/computer/atmos_control/tank{frequency = 1441; input_tag = "air_in"; name = "Mixed Air Supply Control"; output_tag = "air_out"; sensors = list("air_sensor" = "Tank")},/turf/open/floor/plasteel,/area/shuttle/ftl/engine/engineering)
"bX" = (/obj/machinery/meter{name = "Mixed Air Tank Out"},/obj/structure/window/reinforced,/obj/machinery/atmospherics/pipe/simple/supply/hidden,/turf/open/floor/plasteel,/area/shuttle/ftl/engine/engineering)
"bY" = (/obj/structure/window/reinforced,/turf/open/floor/plasteel,/area/shuttle/ftl/engine/engineering)
"bZ" = (/obj/machinery/computer/atmos_control/tank{frequency = 1441; input_tag = "tox_in"; name = "Plasma Supply Control"; output_tag = "tox_out"; sensors = list("tox_sensor" = "Tank")},/obj/structure/window/reinforced,/turf/open/floor/plasteel,/area/shuttle/ftl/engine/engineering)
"ca" = (/obj/structure/window/reinforced,/obj/machinery/atmospherics/pipe/simple/yellow/visible,/turf/open/floor/plasteel,/area/shuttle/ftl/engine/engineering)
"cb" = (/turf/open/floor/plating/airless,/area/shuttle/ftl/munitions/loading)
"cc" = (/obj/structure/cable{icon_state = "0-4"; d2 = 4},/turf/open/floor/plasteel,/area/shuttle/ftl/munitions/loading)
"cd" = (/obj/structure/cable{d1 = 4; d2 = 8; icon_state = "4-8"; pixel_x = 0},/turf/open/floor/plasteel,/area/shuttle/ftl/munitions/loading)
"ce" = (/obj/structure/cable{d1 = 1; d2 = 8; icon_state = "1-8"},/turf/open/floor/plasteel,/area/shuttle/ftl/munitions/loading)
"cf" = (/obj/structure/torpedo,/obj/machinery/atmospherics/components/unary/vent_scrubber{dir = 1; on = 1},/turf/open/floor/plasteel{icon_state = "bot"},/area/shuttle/ftl/munitions/loading)
"cg" = (/obj/machinery/power/port_gen/pacman/super,/obj/structure/cable/yellow,/turf/open/floor/plasteel,/area/shuttle/ftl/engine/engine_smes)
"ch" = (/obj/machinery/power/terminal{dir = 4},/obj/structure/cable/yellow,/obj/machinery/atmospherics/components/unary/vent_pump{dir = 1; external_pressure_bound = 140; on = 1; pressure_checks = 0},/turf/open/floor/plasteel,/area/shuttle/ftl/engine/engine_smes)
"ci" = (/obj/machinery/power/smes,/obj/structure/cable,/turf/open/floor/plasteel,/area/shuttle/ftl/engine/engine_smes)
"cj" = (/obj/machinery/atmospherics/components/unary/outlet_injector/on{dir = 1; frequency = 1441; id = "air_in"},/obj/structure/window/reinforced,/obj/structure/window/reinforced{dir = 8},/obj/structure/window/reinforced{dir = 1},/turf/open/floor/engine/air,/area/shuttle/ftl/engine/engineering)
"ck" = (/obj/machinery/air_sensor{frequency = 1441; id_tag = "air_sensor"},/obj/structure/window/reinforced,/obj/structure/window/reinforced{dir = 1},/obj/machinery/portable_atmospherics/canister/air,/turf/open/floor/engine/air,/area/shuttle/ftl/engine/engineering)
"cl" = (/obj/machinery/atmospherics/components/unary/vent_pump/high_volume{dir = 1; external_pressure_bound = 0; frequency = 1441; icon_state = "vent_map"; id_tag = "air_out"; internal_pressure_bound = 2000; on = 1; pressure_checks = 2; pump_direction = 0},/obj/structure/window/reinforced,/obj/structure/window/reinforced{dir = 4; pixel_x = 0},/obj/structure/window/reinforced{dir = 1},/turf/open/floor/engine/air,/area/shuttle/ftl/engine/engineering)
"cm" = (/obj/structure/window/reinforced,/obj/structure/window/reinforced{dir = 1},/obj/machinery/air_sensor{frequency = 1441; id_tag = "tox_sensor"},/obj/machinery/portable_atmospherics/canister/toxins,/turf/open/floor/engine/air,/area/shuttle/ftl/engine/engineering)
"cn" = (/obj/machinery/atmospherics/pipe/simple/scrubbers/hidden,/turf/closed/wall/r_wall,/area/shuttle/ftl/engine/engineering)
"co" = (/obj/machinery/atmospherics/components/unary/outlet_injector/on{dir = 1; frequency = 1441; id = "air_in"},/turf/open/floor/plating/airless/warnplate/end,/area/shuttle/ftl/engine/engineering)

(1,1,1) = {"
aaaaaaaaaaaaaaaaaaaaaaaaaaaaaaaaaaaaaaaaaaaaaaaaaaaaaaaaaaaaaaaaaaaaaaaaaaaaaaaaaaaaaaaaaaaaaaaaaaaa
aaaaaaaaaaaaaaaaaaaaaaaaaaaaaaaaaaaaaaaaaaaaaaaaaaaaaaaaaaaaaaaaaaaaaaaaaaaaaaaaaaaaaaaaaaaaaaaaaaaa
aaaaaaaaaaaaaaaaaaaaaaaaaaaaaaaaaaaaaaaaaaaaaaaaaaaaaaaaaaaaaaaaaaaaaaaaaaaaaaaaaaaaaaaaaaaaaaaaaaaa
aaaaaaaaaaaaaaaaaaaaaaaaaaaaaaaaaaaaaaaaaaaaaaaaaaaaaaaaaaaaaaaaaaaaaaaaaaaaaaaaaaaaaaaaaaaaaaaaaaaa
aaaaaaaaaaaaaaaaaaaaaaaaaaaaaaaaaaaaaaaaaaaaaaaaaaaaaaaaaaaaaaaaaaaaaaaaaaaaaaaaaaaaaaaaaaaaaaaaaaaa
aaaaaaaaaaaaaaaaaaaaaaaaaaaaaaaaaaaaaaaaaaaaaaaaaaaaaaaaaaaaaaaaaaaaaaaaaaaaaaaaaaaaaaaaaaaaaaaaaaaa
aaaaaaaaaaaaaaaaaaaaaaaaaaaaaaaaaaaaaaaaaaaaaaaaaaaaaaaaaaaaaaaaaaaaaaaaaaaaaaaaaaaaaaaaaaaaaaaaaaaa
aaaaaaaaaaaaaaaaaaaaaaaaaaaaaaaaaaaaaaaaaaaaaaaaaaaaaaaaaaaaaaaaaaaaaaaaaaaaaaaaaaaaaaaaaaaaaaaaaaaa
aaaaaaaaaaaaaaaaaaaaaaaaaaaaaaaaaaaaaaaaaaaaaaaaaaaaaaaaaaaaaaaaaaaaaaaaaaaaaaaaaaaaaaaaaaaaaaaaaaaa
aaaaaaaaaaaaaaaaaaaaaaaaaaaaaaaaaaaaaaaaaaaaaaaaaaaaaaaaaaaaaaaaaaaaaaaaaaaaaaaaaaaaaaaaaaaaaaaaaaaa
aaaaaaaaaaaaaaaaaaaaaaaaaaaaaaaaaaaaaaaaaaaaaaaaaaaaaaaaaaaaaaaaaaaaaaaaaaaaaaaaaaaaaaaaaaaaaaaaaaaa
aaabababababacacacacacacacadadadadaeaeaeaeaeaeaeaeafaaaaaaaaaaaaaaaaaaaaaaaaaaaaaaaaaaaaaaaaaaaaaaaa
aaagahaiajakalamananananaoadapaqadarararaearararaeafaaaaaaaaaaaaaaaaaaaaaaaaaaaaaaaaaaaaaaaaaaaaaaaa
aaasatatatasauavawawaxawayadapaqadarararaearararaeafaaaaaaaaaaaaaaaaaaaaaaaaaaaaaaaaaaaaaaaaaaaaaaaa
aaazaAaBaCasaDaEaFaFaGaFaHadaIadadaraJaraearaKaraeafaaaaaaaaaaaaaaaaaaaaaaaaaaaaaaaaaaaaaaaaaaaaaaaa
aaataLaMaNaOaPaQaRaSaTaRaRaRaUaVaWaXaYaZbabbbcbdaeafaaaaaaaaaaaaaaaaaaaaaaaaaaaaaaaaaaaaaaaaaaaaaaaa
aabebfaBbgbhbibjbkblbmbnbmbmbobmbpbqbrbsbtbubrbvaebwaaaaaaaaaaaaaaaaaaaaaaaaaaaaaaaaaaaaaaaaaaaaaaaa
aaasatatatasbxbybybzbAbBbCbCbDbEbFbGbHbIbJbJbKbLaebwaaaaaaaaaaaaaaaaaaaaaaaaaaaaaaaaaaaaaaaaaaaaaaaa
aabMbNbObPbPbQbybybzbAbRbSbSbTbUaebVbWbXbYbZcabLaebwaaaaaaaaaaaaaaaaaaaaaaaaaaaaaaaaaaaaaaaaaaaaaaaa
aacbcbcccdcdcebybycfbAcgcgcgchciaecjckclcjcmclcnaebwaaaaaaaaaaaaaaaaaaaaaaaaaaaaaaaaaaaaaaaaaaaaaaaa
aabMbMbMbMbMbMbMbMbMbAbAbAbAbAbAaeaeaeaeaeaeaecoaebwaaaaaaaaaaaaaaaaaaaaaaaaaaaaaaaaaaaaaaaaaaaaaaaa
aaaaaaaaaaaaaaaaaaaaaaaaaaaaaaaaaaaaaaaaaaaaaaaaaaaaaaaaaaaaaaaaaaaaaaaaaaaaaaaaaaaaaaaaaaaaaaaaaaaa
aaaaaaaaaaaaaaaaaaaaaaaaaaaaaaaaaaaaaaaaaaaaaaaaaaaaaaaaaaaaaaaaaaaaaaaaaaaaaaaaaaaaaaaaaaaaaaaaaaaa
aaaaaaaaaaaaaaaaaaaaaaaaaaaaaaaaaaaaaaaaaaaaaaaaaaaaaaaaaaaaaaaaaaaaaaaaaaaaaaaaaaaaaaaaaaaaaaaaaaaa
aaaaaaaaaaaaaaaaaaaaaaaaaaaaaaaaaaaaaaaaaaaaaaaaaaaaaaaaaaaaaaaaaaaaaaaaaaaaaaaaaaaaaaaaaaaaaaaaaaaa
aaaaaaaaaaaaaaaaaaaaaaaaaaaaaaaaaaaaaaaaaaaaaaaaaaaaaaaaaaaaaaaaaaaaaaaaaaaaaaaaaaaaaaaaaaaaaaaaaaaa
aaaaaaaaaaaaaaaaaaaaaaaaaaaaaaaaaaaaaaaaaaaaaaaaaaaaaaaaaaaaaaaaaaaaaaaaaaaaaaaaaaaaaaaaaaaaaaaaaaaa
aaaaaaaaaaaaaaaaaaaaaaaaaaaaaaaaaaaaaaaaaaaaaaaaaaaaaaaaaaaaaaaaaaaaaaaaaaaaaaaaaaaaaaaaaaaaaaaaaaaa
aaaaaaaaaaaaaaaaaaaaaaaaaaaaaaaaaaaaaaaaaaaaaaaaaaaaaaaaaaaaaaaaaaaaaaaaaaaaaaaaaaaaaaaaaaaaaaaaaaaa
aaaaaaaaaaaaaaaaaaaaaaaaaaaaaaaaaaaaaaaaaaaaaaaaaaaaaaaaaaaaaaaaaaaaaaaaaaaaaaaaaaaaaaaaaaaaaaaaaaaa
"}
