"aa" = (/turf/template_noop,/area/template_noop)
"ab" = (/obj/structure/window/reinforced{dir = 8},/obj/structure/window/reinforced{dir = 4},/turf/open/floor/plasteel/airless,/area/ship_salvage/component/c_1_1)
"ac" = (/obj/structure/grille,/obj/structure/window/reinforced/fulltile,/turf/open/floor/plating,/area/ship_salvage/hull)
"ad" = (/obj/structure/window/reinforced{dir = 8},/obj/structure/window/reinforced{dir = 4},/turf/open/floor/plasteel/airless,/area/ship_salvage/component/c_3_1)
"ae" = (/obj/structure/lattice/catwalk,/turf/template_noop,/area/ship_salvage/component/c_1_1)
"af" = (/obj/structure/window/reinforced{dir = 8},/obj/structure/window/reinforced{dir = 4},/obj/machinery/power/shipweapon{dir = 1},/obj/structure/cable{d2 = 2; icon_state = "0-2"},/turf/open/floor/plasteel/airless,/area/ship_salvage/component/c_1_1)
"ag" = (/obj/structure/table,/turf/open/floor/plasteel/red,/area/ship_salvage/component/c_2_1)
"ah" = (/obj/structure/table,/obj/effect/spawner/lootdrop/raresalvage_spawner,/turf/open/floor/plasteel/red,/area/ship_salvage/component/c_2_1)
"ai" = (/obj/machinery/computer,/turf/open/floor/plasteel/red,/area/ship_salvage/component/c_2_1)
"aj" = (/obj/structure/lattice/catwalk,/turf/template_noop,/area/ship_salvage/component/c_3_1)
"ak" = (/obj/structure/window/reinforced{dir = 8},/obj/structure/window/reinforced{dir = 4},/obj/machinery/power/shipweapon{dir = 1},/obj/structure/cable{d2 = 2; icon_state = "0-2"},/turf/open/floor/plasteel/airless,/area/ship_salvage/component/c_3_1)
"al" = (/obj/structure/lattice/catwalk,/obj/structure/cable{d1 = 1; d2 = 2; icon_state = "1-2"},/turf/template_noop,/area/ship_salvage/component/c_1_1)
"am" = (/obj/structure/chair{dir = 8},/turf/open/floor/plasteel/red,/area/ship_salvage/component/c_2_1)
"an" = (/obj/structure/chair{dir = 1},/turf/open/floor/plasteel/red,/area/ship_salvage/component/c_2_1)
"ao" = (/obj/structure/chair{dir = 4},/turf/open/floor/plasteel/red,/area/ship_salvage/component/c_2_1)
"ap" = (/obj/structure/lattice/catwalk,/obj/structure/cable{d1 = 1; d2 = 2; icon_state = "1-2"},/turf/template_noop,/area/ship_salvage/component/c_3_1)
"aq" = (/turf/closed/wall,/area/ship_salvage/hull)
"ar" = (/obj/machinery/door/airlock/external{req_access_txt = "150"},/obj/structure/cable{d1 = 1; d2 = 2; icon_state = "1-2"},/turf/open/floor/plating,/area/ship_salvage/component/c_1_1)
"as" = (/turf/open/floor/plasteel/red,/area/ship_salvage/component/c_2_1)
"at" = (/obj/machinery/door/airlock/external{req_access_txt = "150"},/obj/structure/cable{d1 = 1; d2 = 2; icon_state = "1-2"},/turf/open/floor/plating,/area/ship_salvage/component/c_3_1)
"au" = (/obj/structure/cable{d1 = 1; d2 = 2; icon_state = "1-2"},/turf/open/floor/plating,/area/ship_salvage/component/c_1_1)
"av" = (/obj/machinery/door/airlock/glass_command{name = "Cockpit"; req_access_txt = "150"},/turf/open/floor/plasteel/red,/area/ship_salvage/component/c_2_1)
"aw" = (/obj/structure/cable{d1 = 1; d2 = 2; icon_state = "1-2"},/turf/open/floor/plating,/area/ship_salvage/component/c_3_1)
"ax" = (/obj/machinery/power/port_gen/pacman,/obj/structure/cable{d2 = 4; icon_state = "0-4"},/turf/open/floor/plasteel/yellow,/area/ship_salvage/component/c_2_2)
"ay" = (/obj/structure/cable{d1 = 2; d2 = 8; icon_state = "2-8"},/obj/structure/cable{d1 = 2; d2 = 4; icon_state = "2-4"},/turf/open/floor/plasteel/yellow,/area/ship_salvage/component/c_2_2)
"az" = (/obj/structure/cable{d1 = 4; d2 = 8; icon_state = "4-8"},/turf/open/floor/plasteel/yellow,/area/ship_salvage/component/c_2_2)
"aA" = (/obj/structure/cable{d1 = 2; d2 = 8; icon_state = "2-8"},/obj/structure/cable{d1 = 4; d2 = 8; icon_state = "4-8"},/turf/open/floor/plasteel/yellow,/area/ship_salvage/component/c_2_2)
"aB" = (/obj/machinery/power/port_gen/pacman,/obj/structure/cable{d2 = 8; icon_state = "0-8"},/turf/open/floor/plasteel/yellow,/area/ship_salvage/component/c_2_2)
"aC" = (/turf/open/floor/plasteel/yellow,/area/ship_salvage/component/c_1_2)
"aD" = (/obj/structure/cable{d1 = 1; d2 = 2; icon_state = "1-2"},/turf/open/floor/plasteel/yellow,/area/ship_salvage/component/c_1_2)
"aE" = (/obj/machinery/portable_atmospherics/canister/toxins,/obj/machinery/atmospherics/components/unary/portables_connector/visible,/turf/open/floor/plasteel/yellow,/area/ship_salvage/component/c_1_2)
"aF" = (/obj/structure/cable{d1 = 2; d2 = 8; icon_state = "2-8"},/obj/structure/cable{d1 = 1; d2 = 2; icon_state = "1-2"},/turf/open/floor/plasteel/yellow,/area/ship_salvage/component/c_2_2)
"aG" = (/obj/structure/table,/obj/item/stack/sheet/glass/fifty{pixel_x = -3; pixel_y = 3},/obj/item/stack/sheet/glass/fifty,/turf/open/floor/plasteel/yellow,/area/ship_salvage/component/c_2_2)
"aH" = (/obj/structure/cable{d1 = 1; d2 = 4; icon_state = "1-4"},/obj/structure/cable{d1 = 1; d2 = 2; icon_state = "1-2"},/turf/open/floor/plasteel/yellow,/area/ship_salvage/component/c_2_2)
"aI" = (/obj/machinery/portable_atmospherics/canister/toxins,/obj/machinery/atmospherics/components/unary/portables_connector/visible,/turf/open/floor/plasteel/yellow,/area/ship_salvage/component/c_3_2)
"aJ" = (/obj/structure/cable{d1 = 1; d2 = 2; icon_state = "1-2"},/turf/open/floor/plasteel/yellow,/area/ship_salvage/component/c_3_2)
"aK" = (/obj/effect/spawner/lootdrop/salvage_spawner,/turf/open/floor/plasteel/yellow,/area/ship_salvage/component/c_3_2)
"aL" = (/obj/structure/cable{d1 = 1; d2 = 4; icon_state = "1-4"},/turf/open/floor/plasteel/yellow,/area/ship_salvage/component/c_1_2)
"aM" = (/obj/machinery/atmospherics/pipe/simple/general/visible,/obj/structure/cable{d1 = 4; d2 = 8; icon_state = "4-8"},/turf/open/floor/plasteel/yellow,/area/ship_salvage/component/c_1_2)
"aN" = (/obj/machinery/door/airlock/engineering{name = "Shield Generator Room"; req_access_txt = "150"},/obj/structure/cable{d1 = 4; d2 = 8; icon_state = "4-8"},/turf/open/floor/plasteel/yellow,/area/ship_salvage/component/c_1_2)
"aO" = (/obj/structure/cable{d1 = 1; d2 = 2; icon_state = "1-2"},/obj/structure/cable{d1 = 4; d2 = 8; icon_state = "4-8"},/turf/open/floor/plasteel/yellow,/area/ship_salvage/component/c_2_2)
"aP" = (/obj/structure/table,/obj/structure/cable{d1 = 2; d2 = 8; icon_state = "2-8"},/obj/structure/cable{d1 = 2; d2 = 4; icon_state = "2-4"},/obj/item/stack/sheet/metal/fifty{pixel_x = -3; pixel_y = 3},/obj/item/stack/sheet/metal/fifty,/turf/open/floor/plasteel/yellow,/area/ship_salvage/component/c_2_2)
"aQ" = (/obj/machinery/door/airlock/engineering{name = "Shield Generator Room"; req_access_txt = "150"},/obj/structure/cable{d1 = 4; d2 = 8; icon_state = "4-8"},/turf/open/floor/plasteel/yellow,/area/ship_salvage/component/c_3_2)
"aR" = (/obj/machinery/atmospherics/pipe/simple/general/visible,/obj/structure/cable{d1 = 4; d2 = 8; icon_state = "4-8"},/turf/open/floor/plasteel/yellow,/area/ship_salvage/component/c_3_2)
"aS" = (/obj/structure/cable{d1 = 1; d2 = 8; icon_state = "1-8"},/turf/open/floor/plasteel/yellow,/area/ship_salvage/component/c_3_2)
"aT" = (/turf/open/floor/plasteel/yellow,/area/ship_salvage/component/c_3_2)
"aU" = (/obj/machinery/atmospherics/pipe/simple/general/visible,/turf/open/floor/plasteel/yellow,/area/ship_salvage/component/c_1_2)
"aV" = (/obj/machinery/power/smes/engineering,/obj/structure/cable,/turf/open/floor/plasteel/yellow,/area/ship_salvage/component/c_2_2)
"aW" = (/obj/machinery/atmospherics/pipe/simple/general/visible,/turf/open/floor/plasteel/yellow,/area/ship_salvage/component/c_3_2)
"aX" = (/obj/machinery/ftl_shieldgen{plasma_charge = 0; power_charge = 0},/turf/open/floor/plasteel/yellow,/area/ship_salvage/component/c_1_2)
"aY" = (/obj/structure/cable{d1 = 1; d2 = 4; icon_state = "1-4"},/obj/structure/cable{d1 = 4; d2 = 8; icon_state = "4-8"},/turf/open/floor/plasteel/yellow,/area/ship_salvage/component/c_2_2)
"aZ" = (/obj/structure/cable{d2 = 8; icon_state = "0-8"},/obj/machinery/power/terminal{dir = 1},/turf/open/floor/plasteel/yellow,/area/ship_salvage/component/c_2_2)
"ba" = (/obj/structure/cable{d1 = 1; d2 = 4; icon_state = "1-4"},/turf/open/floor/plasteel/yellow,/area/ship_salvage/component/c_2_2)
"bb" = (/obj/machinery/ftl_shieldgen{plasma_charge = 0; power_charge = 0},/turf/open/floor/plasteel/yellow,/area/ship_salvage/component/c_3_2)
"bc" = (/obj/machinery/atmospherics/pipe/simple/general/visible{dir = 5},/turf/closed/wall,/area/ship_salvage/hull)
"bd" = (/obj/machinery/atmospherics/pipe/simple/general/visible{dir = 9},/turf/closed/wall,/area/ship_salvage/hull)
"be" = (/obj/machinery/door/airlock/engineering{name = "Thrusters"; req_access_txt = "150"},/turf/open/floor/plating,/area/ship_salvage/component/c_2_3)
"bf" = (/turf/open/floor/plating,/area/ship_salvage/component/c_1_3)
"bg" = (/obj/machinery/atmospherics/components/unary/portables_connector/visible,/obj/machinery/portable_atmospherics/canister/toxins,/turf/open/floor/plating,/area/ship_salvage/component/c_1_3)
"bh" = (/obj/machinery/atmospherics/components/unary/portables_connector/visible,/obj/machinery/portable_atmospherics/canister/toxins,/turf/open/floor/plating,/area/ship_salvage/component/c_2_3)
"bi" = (/turf/open/floor/plating,/area/ship_salvage/component/c_2_3)
"bj" = (/obj/machinery/atmospherics/components/unary/portables_connector/visible,/obj/machinery/portable_atmospherics/canister/toxins,/turf/open/floor/plating,/area/ship_salvage/component/c_3_3)
"bk" = (/turf/open/floor/plating,/area/ship_salvage/component/c_3_3)
"bl" = (/obj/effect/spawner/lootdrop/raresalvage_spawner,/turf/open/floor/plating,/area/ship_salvage/component/c_3_3)
"bm" = (/obj/machinery/atmospherics/pipe/simple/general/visible,/turf/open/floor/plating,/area/ship_salvage/component/c_1_3)
"bn" = (/obj/machinery/door/airlock/engineering{name = "Thrusters"; req_access_txt = "150"},/turf/open/floor/plating,/area/ship_salvage/component/c_1_3)
"bo" = (/obj/machinery/atmospherics/pipe/simple/general/visible,/turf/open/floor/plating,/area/ship_salvage/component/c_2_3)
"bp" = (/obj/machinery/door/airlock/engineering{name = "Thrusters"; req_access_txt = "150"},/turf/open/floor/plating,/area/ship_salvage/component/c_3_3)
"bq" = (/obj/machinery/atmospherics/pipe/simple/general/visible,/turf/open/floor/plating,/area/ship_salvage/component/c_3_3)
"br" = (/obj/machinery/atmospherics/pipe/simple/general/visible{dir = 6},/turf/open/floor/plating,/area/ship_salvage/component/c_1_3)
"bs" = (/obj/machinery/atmospherics/pipe/manifold/general/visible{dir = 1},/obj/effect/spawner/lootdrop/salvage_spawner,/turf/open/floor/plating,/area/ship_salvage/component/c_1_3)
"bt" = (/obj/machinery/atmospherics/pipe/manifold/general/visible{dir = 1},/turf/open/floor/plating,/area/ship_salvage/component/c_1_3)
"bu" = (/obj/machinery/atmospherics/pipe/manifold/general/visible{dir = 4},/turf/open/floor/plating,/area/ship_salvage/component/c_1_3)
"bv" = (/obj/machinery/atmospherics/pipe/manifold/general/visible{dir = 8},/turf/open/floor/plating,/area/ship_salvage/component/c_2_3)
"bw" = (/obj/machinery/atmospherics/pipe/manifold/general/visible{dir = 1},/turf/open/floor/plating,/area/ship_salvage/component/c_2_3)
"bx" = (/obj/effect/spawner/lootdrop/crate_spawner,/turf/open/floor/plating,/area/ship_salvage/component/c_2_3)
"by" = (/obj/machinery/atmospherics/pipe/simple/general/visible{dir = 10},/turf/open/floor/plating,/area/ship_salvage/component/c_2_3)
"bz" = (/obj/machinery/atmospherics/pipe/manifold/general/visible{dir = 8},/turf/open/floor/plating,/area/ship_salvage/component/c_3_3)
"bA" = (/obj/machinery/atmospherics/pipe/manifold/general/visible{dir = 1},/turf/open/floor/plating,/area/ship_salvage/component/c_3_3)
"bB" = (/obj/machinery/atmospherics/pipe/simple/general/visible{dir = 10},/turf/open/floor/plating,/area/ship_salvage/component/c_3_3)
"bC" = (/obj/structure/shuttle/engine/heater,/obj/structure/window/reinforced{dir = 1},/obj/machinery/atmospherics/pipe/simple/general/visible,/turf/open/floor/plating,/area/ship_salvage/component/c_1_3)
"bD" = (/obj/structure/shuttle/engine/heater,/obj/structure/window/reinforced{dir = 1},/obj/machinery/atmospherics/pipe/simple/general/visible,/turf/open/floor/plating,/area/ship_salvage/component/c_2_3)
"bE" = (/obj/structure/shuttle/engine/heater,/obj/structure/window/reinforced{dir = 1},/obj/machinery/atmospherics/pipe/simple/general/visible,/turf/open/floor/plating,/area/ship_salvage/component/c_3_3)
"bF" = (/obj/structure/shuttle/engine/propulsion,/turf/template_noop,/area/ship_salvage/component/c_1_3)
"bG" = (/obj/structure/shuttle/engine/propulsion,/turf/template_noop,/area/ship_salvage/component/c_2_3)
"bH" = (/obj/structure/shuttle/engine/propulsion,/turf/template_noop,/area/ship_salvage/component/c_3_3)

(1,1,1) = {"
aaaaaaaaabaaacacacacacacacaaadaaaaaaaa
aaaaaaaeafaeacagahaiagagacajakajaaaaaa
aaaaaaaealaeacaiamanaoaiacajapajaaaaaa
aaaaaaaqaraqaqagasasasagaqaqataqaaaaaa
aaaaaaaqauaqaqaqaqavaqaqaqaqawaqaaaaaa
aaaaaqaqaraqaqaxayazaAaBaqaqataqaqaaaa
aaaaaqaCaDaEaqaxaFaGaHaBaqaIaJaKaqaaaa
aaaaaqaCaLaMaNazaOaPaOazaQaRaSaTaqaaaa
aaaaaqaCaCaUaqaxaFaVaHaBaqaWaTaTaqaaaa
aaaaaqaCaXaUaqaxaYaZbaaBaqaWbbaTaqaaaa
aaaaaqaqbcbdaqaqaqbeaqaqaqbcbdaqaqaaaa
aaaaaqbfbfbgaqbhbibibibiaqbjbkblaqaaaa
aaaqbfbfbfbmbnbobibibibibpbqbkbkbkaqaa
aqbrbsbtbtbuaqbvbwbxbwbyaqbzbAbAbAbBaq
aqbCbCbCbCbCaqbDbDbDbDbDaqbEbEbEbEbEaq
aqbFbFbFbFbFaqbGbGbGbGbGaqbHbHbHbHbHaq
"}
