//MAP CONVERTED BY dmm2tgm.py THIS HEADER COMMENT PREVENTS RECONVERSION, DO NOT REMOVE 
"aU" = (
/obj/structure/cable{
	d1 = 2;
	d2 = 8;
	icon_state = "2-8"
	},
/turf/open/floor/plating/airless,
/area/ship_salvage/component/c_2_1)
"dI" = (
/obj/machinery/power/terminal{
	dir = 1
	},
/obj/structure/cable{
	d2 = 2;
	icon_state = "0-2"
	},
/obj/structure/cable{
	d2 = 4;
	icon_state = "0-4"
	},
/turf/open/floor/plating/airless,
/area/ship_salvage/component/c_2_1)
"hN" = (
/obj/structure/cable{
	d1 = 1;
	d2 = 2;
	icon_state = "1-2"
	},
/turf/closed/wall,
/area/ship_salvage/hull)
"il" = (
/obj/structure/AIcore/deactivated,
/turf/open/floor/plating/airless,
/area/ship_salvage/component/c_2_1)
"iI" = (
/obj/machinery/atmospherics/pipe/manifold/general/visible{
	dir = 1
	},
/turf/open/floor/plating/airless,
/area/ship_salvage/component/c_3_1)
"iO" = (
/obj/structure/cable{
	d1 = 4;
	d2 = 8;
	icon_state = "4-8"
	},
/turf/open/floor/plating/airless,
/area/ship_salvage/component/c_2_1)
"iW" = (
/obj/structure/lattice/catwalk,
/obj/structure/cable{
	d1 = 2;
	d2 = 8;
	icon_state = "2-8"
	},
/turf/template_noop,
/area/ship_salvage/component/c_2_1)
"jI" = (
/obj/machinery/atmospherics/pipe/manifold/general/visible{
	dir = 1
	},
/turf/open/floor/plating/airless,
/area/ship_salvage/component/c_1_1)
"kk" = (
/obj/machinery/atmospherics/components/unary/portables_connector/visible,
/obj/machinery/portable_atmospherics/canister/toxins,
/turf/open/floor/plating/airless,
/area/ship_salvage/component/c_1_1)
"nk" = (
/turf/closed/wall/r_wall,
/area/ship_salvage/hull)
"pg" = (
/turf/open/floor/plating/airless,
/area/ship_salvage/component/c_1_1)
"sF" = (
/obj/machinery/power/port_gen/pacman,
/obj/structure/cable,
/turf/open/floor/plating/airless,
/area/ship_salvage/component/c_2_1)
"vy" = (
/obj/machinery/atmospherics/pipe/manifold/general/visible{
	dir = 4
	},
/turf/open/floor/plating/airless,
/area/ship_salvage/component/c_1_1)
"wj" = (
/obj/machinery/atmospherics/pipe/simple/general/visible{
	dir = 6
	},
/turf/open/floor/plating/airless,
/area/ship_salvage/component/c_1_1)
"xM" = (
/obj/machinery/atmospherics/pipe/manifold/general/visible{
	dir = 8
	},
/turf/open/floor/plating/airless,
/area/ship_salvage/component/c_3_1)
"zc" = (
/obj/structure/window/reinforced{
	dir = 8
	},
/obj/structure/window/reinforced{
	dir = 4
	},
/obj/structure/cable{
	d2 = 2;
	icon_state = "0-2"
	},
/obj/machinery/power/shipweapon{
	dir = 1
	},
/turf/open/floor/plasteel,
/area/ship_salvage/component/c_2_1)
"zt" = (
/obj/structure/lattice/catwalk,
/turf/template_noop,
/area/ship_salvage/component/c_2_1)
"Ak" = (
/obj/structure/cable{
	d1 = 1;
	d2 = 8;
	icon_state = "1-8"
	},
/turf/open/floor/plating/airless,
/area/ship_salvage/component/c_2_1)
"At" = (
/obj/structure/lattice/catwalk,
/obj/structure/cable{
	d1 = 2;
	d2 = 4;
	icon_state = "2-4"
	},
/turf/template_noop,
/area/ship_salvage/component/c_2_1)
"AD" = (
/obj/structure/shuttle/engine/propulsion,
/turf/template_noop,
/area/ship_salvage/hull)
"AH" = (
/obj/structure/cable{
	d1 = 2;
	d2 = 8;
	icon_state = "2-8"
	},
/obj/structure/cable{
	d1 = 4;
	d2 = 8;
	icon_state = "4-8"
	},
/turf/open/floor/plating/airless,
/area/ship_salvage/component/c_2_1)
"AZ" = (
/obj/machinery/atmospherics/pipe/simple/general/visible,
/turf/open/floor/plating/airless,
/area/ship_salvage/component/c_1_1)
"Bv" = (
/obj/structure/lattice/catwalk,
/obj/structure/cable{
	d1 = 1;
	d2 = 8;
	icon_state = "1-8"
	},
/turf/template_noop,
/area/ship_salvage/component/c_2_1)
"DY" = (
/obj/machinery/atmospherics/pipe/simple/general/visible{
	dir = 10
	},
/turf/open/floor/plating/airless,
/area/ship_salvage/component/c_3_1)
"Ge" = (
/obj/structure/lattice/catwalk,
/obj/structure/cable{
	d1 = 1;
	d2 = 4;
	icon_state = "1-4"
	},
/turf/template_noop,
/area/ship_salvage/component/c_2_1)
"GR" = (
/obj/machinery/atmospherics/components/unary/portables_connector/visible,
/obj/machinery/portable_atmospherics/canister/toxins,
/turf/open/floor/plating/airless,
/area/ship_salvage/component/c_3_1)
"Kd" = (
/obj/structure/shuttle/engine/heater,
/obj/machinery/atmospherics/pipe/simple/general/visible,
/turf/open/floor/plating/airless,
/area/ship_salvage/component/c_3_1)
"Lv" = (
/obj/structure/window/reinforced{
	dir = 4
	},
/obj/structure/window/reinforced{
	dir = 8
	},
/obj/structure/cable{
	d2 = 2;
	icon_state = "0-2"
	},
/obj/machinery/power/shipweapon{
	dir = 1
	},
/turf/open/floor/plasteel,
/area/ship_salvage/component/c_2_1)
"Nh" = (
/turf/template_noop,
/area/template_noop)
"NN" = (
/obj/structure/shuttle/engine/heater,
/obj/machinery/atmospherics/pipe/simple/general/visible,
/turf/open/floor/plating/airless,
/area/ship_salvage/component/c_1_1)
"Qp" = (
/turf/open/floor/plating/airless,
/area/ship_salvage/component/c_2_1)
"QR" = (
/obj/structure/cable{
	d2 = 4;
	icon_state = "0-4"
	},
/obj/structure/cable,
/obj/machinery/power/smes,
/turf/open/floor/plating/airless,
/area/ship_salvage/component/c_2_1)
"Sw" = (
/obj/machinery/atmospherics/pipe/simple/general/visible,
/turf/open/floor/plating/airless,
/area/ship_salvage/component/c_3_1)
"SJ" = (
/obj/structure/shuttle/engine/propulsion,
/turf/template_noop,
/area/ship_salvage/component/c_1_1)
"Te" = (
/turf/open/floor/plating/airless,
/area/ship_salvage/component/c_3_1)
"Vw" = (
/obj/structure/window/reinforced{
	dir = 8
	},
/obj/structure/window/reinforced{
	dir = 4
	},
/turf/open/floor/plasteel,
/area/ship_salvage/component/c_2_1)
"VP" = (
/turf/closed/wall,
/area/ship_salvage/hull)

(1,1,1) = {"
Nh
Nh
Nh
Nh
Nh
Nh
VP
VP
VP
"}
(2,1,1) = {"
Nh
Nh
Nh
Nh
Nh
VP
wj
NN
SJ
"}
(3,1,1) = {"
Nh
Nh
Nh
Nh
VP
pg
jI
NN
SJ
"}
(4,1,1) = {"
Nh
Nh
Nh
VP
pg
pg
jI
NN
SJ
"}
(5,1,1) = {"
Nh
Nh
Nh
VP
pg
pg
jI
NN
SJ
"}
(6,1,1) = {"
Nh
Nh
Nh
VP
kk
AZ
vy
NN
SJ
"}
(7,1,1) = {"
Nh
Nh
Nh
VP
VP
pg
VP
VP
VP
"}
(8,1,1) = {"
Nh
zt
At
hN
QR
dI
sF
VP
Nh
"}
(9,1,1) = {"
Vw
zc
Bv
VP
iO
AH
sF
VP
Nh
"}
(10,1,1) = {"
Nh
zt
zt
VP
iO
iO
nk
nk
Nh
"}
(11,1,1) = {"
Nh
zt
zt
Qp
iO
iO
il
nk
Nh
"}
(12,1,1) = {"
Nh
zt
zt
VP
iO
iO
nk
nk
Nh
"}
(13,1,1) = {"
Vw
Lv
Ge
VP
iO
AH
sF
VP
Nh
"}
(14,1,1) = {"
Nh
zt
iW
hN
Ak
aU
sF
VP
Nh
"}
(15,1,1) = {"
Nh
Nh
Nh
VP
VP
Te
VP
VP
VP
"}
(16,1,1) = {"
Nh
Nh
Nh
VP
GR
Sw
xM
Kd
AD
"}
(17,1,1) = {"
Nh
Nh
Nh
VP
Te
Te
iI
Kd
AD
"}
(18,1,1) = {"
Nh
Nh
Nh
VP
VP
Te
iI
Kd
AD
"}
(19,1,1) = {"
Nh
Nh
Nh
Nh
VP
Te
iI
Kd
AD
"}
(20,1,1) = {"
Nh
Nh
Nh
Nh
Nh
VP
DY
Kd
AD
"}
(21,1,1) = {"
Nh
Nh
Nh
Nh
Nh
Nh
VP
VP
VP
"}
