"aa" = (/turf/template_noop,/area/template_noop)
"ab" = (/obj/structure/lattice/catwalk,/turf/open/space,/area/ship_salvage/component/c_1_1)
"ac" = (/obj/structure/lattice/catwalk,/turf/open/space,/area/template_noop)
"ad" = (/obj/structure/lattice/catwalk,/turf/open/space,/area/ship_salvage/component/c_3_1)
"ae" = (/obj/structure/lattice/catwalk,/obj/machinery/power/shipweapon{dir = 1},/obj/structure/window/reinforced{dir = 8},/turf/open/space,/area/ship_salvage/component/c_1_1)
"af" = (/turf/closed/wall/r_wall,/area/ship_salvage/hull)
"ag" = (/obj/structure/grille,/obj/structure/window/reinforced/fulltile,/turf/open/floor/plasteel/darkblue,/area/ship_salvage/hull)
"ah" = (/obj/structure/lattice/catwalk,/obj/machinery/power/shipweapon{dir = 1},/obj/structure/window/reinforced{dir = 4},/turf/open/space,/area/ship_salvage/component/c_3_1)
"ai" = (/turf/open/floor/plasteel/darkblue,/area/ship_salvage/component/c_2_1)
"aj" = (/turf/open/floor/plasteel/black,/area/ship_salvage/component/c_2_1)
"ak" = (/obj/machinery/computer/ftl_navigation,/turf/open/floor/plasteel/bar,/area/ship_salvage/component/c_2_1)
"al" = (/obj/machinery/computer/ftl_navigation,/turf/open/floor/plasteel/darkblue,/area/ship_salvage/component/c_2_1)
"am" = (/turf/closed/wall,/area/ship_salvage/hull)
"an" = (/obj/machinery/door/airlock/command,/turf/open/floor/plasteel/bar,/area/ship_salvage/hull)
"ao" = (/turf/open/floor/plasteel/darkwarning,/area/ship_salvage/component/c_1_2)
"ap" = (/turf/open/floor/plasteel/darkwarning/corner{tag = "icon-black_warn_corner (NORTH)"; icon_state = "black_warn_corner"; dir = 1},/area/ship_salvage/component/c_1_2)
"aq" = (/turf/open/floor/plasteel/black,/area/ship_salvage/component/c_2_2)
"ar" = (/turf/open/floor/plasteel/darkwarning/corner,/area/ship_salvage/component/c_3_2)
"as" = (/turf/open/floor/plasteel/darkwarning,/area/ship_salvage/component/c_3_2)
"at" = (/turf/open/floor/engine,/area/ship_salvage/component/c_1_2)
"au" = (/turf/open/floor/plasteel/darkwarning{tag = "icon-black_warn (WEST)"; icon_state = "black_warn"; dir = 8},/area/ship_salvage/component/c_1_2)
"av" = (/turf/open/floor/plasteel/darkwarning{tag = "icon-black_warn (EAST)"; icon_state = "black_warn"; dir = 4},/area/ship_salvage/component/c_3_2)
"aw" = (/turf/open/floor/engine,/area/ship_salvage/component/c_3_2)
"ax" = (/obj/machinery/ftl_drive,/turf/open/floor/engine,/area/ship_salvage/component/c_1_2)
"ay" = (/obj/machinery/ftl_shieldgen{plasma_charge = 0; power_charge = 0},/turf/open/floor/engine,/area/ship_salvage/component/c_3_2)
"az" = (/obj/machinery/door/airlock/glass_security,/turf/open/floor/plasteel/black,/area/ship_salvage/hull)
"aA" = (/obj/structure/grille,/obj/structure/window/reinforced/fulltile,/turf/open/floor/plasteel,/area/ship_salvage/hull)
"aB" = (/turf/open/floor/plasteel,/area/ship_salvage/component/c_1_3)
"aC" = (/turf/open/floor/plasteel/yellow,/area/ship_salvage/component/c_1_3)
"aD" = (/turf/open/floor/plasteel/delivery,/area/ship_salvage/component/c_2_3)
"aE" = (/turf/open/floor/plasteel/black,/area/ship_salvage/component/c_2_3)
"aF" = (/turf/open/floor/plasteel/yellow,/area/ship_salvage/component/c_3_3)
"aG" = (/turf/open/floor/plasteel,/area/ship_salvage/component/c_3_3)
"aH" = (/turf/closed/wall,/area/ship_salvage/component/c_1_3)
"aI" = (/mob/living/simple_animal/bot/mulebot,/turf/open/floor/plasteel,/area/ship_salvage/component/c_3_3)
"aJ" = (/obj/machinery/door/airlock/external{req_access_txt = "150"},/turf/closed/wall/r_wall,/area/ship_salvage/hull)
"aK" = (/obj/machinery/door/airlock/external{req_access_txt = "150"},/turf/open/floor/plasteel,/area/ship_salvage/component/c_1_3)
"aL" = (/turf/open/floor/plasteel/yellow,/area/ship_salvage/component/c_2_3)
"aM" = (/obj/machinery/door/airlock/external{req_access_txt = "150"},/turf/open/floor/plasteel,/area/ship_salvage/hull)
"aN" = (/turf/open/floor/plasteel,/area/ship_salvage/component/c_1_4)
"aO" = (/obj/machinery/door/airlock/external{req_access_txt = "150"},/turf/open/floor/plasteel,/area/ship_salvage/component/c_1_4)
"aP" = (/turf/open/floor/plasteel/yellow,/area/ship_salvage/component/c_1_4)
"aQ" = (/turf/open/floor/plasteel/yellow,/area/ship_salvage/component/c_2_4)
"aR" = (/turf/open/floor/plasteel/yellow,/area/ship_salvage/component/c_3_4)
"aS" = (/turf/open/floor/plasteel,/area/ship_salvage/component/c_3_4)
"aT" = (/turf/closed/wall,/area/ship_salvage/component/c_1_4)
"aU" = (/turf/open/floor/plasteel/delivery,/area/ship_salvage/component/c_2_4)
"aV" = (/turf/open/floor/plasteel/black,/area/ship_salvage/component/c_2_4)
"aW" = (/turf/open/floor/plasteel/delivery,/area/ship_salvage/component/c_3_4)
"aX" = (/turf/open/floor/plasteel/delivery,/area/ship_salvage/component/c_1_4)
"aY" = (/obj/machinery/door/airlock/engineering,/turf/open/floor/plasteel/black,/area/ship_salvage/hull)
"aZ" = (/turf/open/floor/plating,/area/ship_salvage/component/c_1_5)
"ba" = (/obj/machinery/atmospherics/pipe/simple/general/visible{dir = 6},/turf/open/floor/plating,/area/ship_salvage/component/c_1_5)
"bb" = (/obj/machinery/door/airlock/maintenance_hatch{name = "Thruster Compartment"; req_access_txt = "150"},/obj/machinery/atmospherics/pipe/simple/general/visible{dir = 4},/turf/open/floor/plasteel/darkwarning,/area/ship_salvage/hull)
"bc" = (/obj/machinery/atmospherics/pipe/simple/general/visible{dir = 4},/turf/open/floor/plasteel/darkwarning,/area/ship_salvage/component/c_2_5)
"bd" = (/obj/machinery/atmospherics/pipe/manifold/general/visible{dir = 1},/turf/open/floor/plasteel/darkwarning,/area/ship_salvage/component/c_2_5)
"be" = (/obj/machinery/door/airlock/maintenance_hatch{name = "Thruster Compartment"; req_access_txt = "150"},/turf/open/floor/plasteel/darkwarning,/area/ship_salvage/hull)
"bf" = (/obj/machinery/atmospherics/pipe/simple/general/visible{dir = 10},/turf/open/floor/plating,/area/ship_salvage/component/c_3_5)
"bg" = (/turf/open/floor/plating,/area/ship_salvage/component/c_3_5)
"bh" = (/obj/machinery/atmospherics/pipe/manifold/general/visible{dir = 1},/turf/open/floor/plating,/area/ship_salvage/component/c_1_5)
"bi" = (/obj/machinery/atmospherics/pipe/manifold/general/visible{dir = 4; initialize_directions = 11},/turf/open/floor/plating,/area/ship_salvage/component/c_1_5)
"bj" = (/turf/open/floor/plasteel/yellow/side{tag = "icon-yellow (NORTHWEST)"; icon_state = "yellow"; dir = 9},/area/ship_salvage/component/c_2_5)
"bk" = (/turf/open/floor/plasteel/yellow/side{tag = "icon-yellow (NORTH)"; icon_state = "yellow"; dir = 1},/area/ship_salvage/component/c_2_5)
"bl" = (/obj/machinery/atmospherics/pipe/simple/general/visible,/turf/open/floor/plasteel/yellow/side{tag = "icon-yellow (NORTH)"; icon_state = "yellow"; dir = 1},/area/ship_salvage/component/c_2_5)
"bm" = (/turf/open/floor/plasteel/yellow/side{tag = "icon-yellow (NORTHEAST)"; icon_state = "yellow"; dir = 5},/area/ship_salvage/component/c_2_5)
"bn" = (/obj/machinery/atmospherics/pipe/manifold/general/visible{dir = 8},/turf/open/floor/plating,/area/ship_salvage/component/c_3_5)
"bo" = (/obj/machinery/atmospherics/pipe/manifold/general/visible{dir = 1},/turf/open/floor/plating,/area/ship_salvage/component/c_3_5)
"bp" = (/obj/machinery/atmospherics/pipe/simple/general/visible,/turf/open/floor/plating,/area/ship_salvage/component/c_1_5)
"bq" = (/turf/open/floor/plasteel/yellow/side{dir = 8},/area/ship_salvage/component/c_2_5)
"br" = (/turf/open/floor/plasteel,/area/ship_salvage/component/c_2_5)
"bs" = (/obj/machinery/atmospherics/pipe/simple/general/visible{dir = 6},/turf/open/floor/plasteel,/area/ship_salvage/component/c_2_5)
"bt" = (/obj/machinery/atmospherics/pipe/simple/general/visible{dir = 4},/turf/open/floor/plasteel,/area/ship_salvage/component/c_2_5)
"bu" = (/obj/machinery/atmospherics/pipe/manifold/general/visible,/turf/open/floor/plasteel,/area/ship_salvage/component/c_2_5)
"bv" = (/obj/machinery/atmospherics/pipe/simple/general/visible{dir = 10},/turf/open/floor/plasteel,/area/ship_salvage/component/c_2_5)
"bw" = (/turf/open/floor/plasteel/yellow/side{dir = 4},/area/ship_salvage/component/c_2_5)
"bx" = (/obj/machinery/atmospherics/pipe/simple/general/visible,/turf/open/floor/plating,/area/ship_salvage/component/c_3_5)
"by" = (/obj/structure/shuttle/engine/heater,/obj/structure/window/reinforced{dir = 1},/obj/machinery/atmospherics/pipe/simple/general/visible,/turf/open/floor/plating,/area/ship_salvage/component/c_1_5)
"bz" = (/obj/structure/table/reinforced,/turf/open/floor/plasteel/yellow/side{tag = "icon-yellow (SOUTHWEST)"; icon_state = "yellow"; dir = 10},/area/ship_salvage/component/c_2_5)
"bA" = (/obj/structure/table/reinforced,/turf/open/floor/plasteel/yellow/side,/area/ship_salvage/component/c_2_5)
"bB" = (/turf/open/floor/plasteel/yellow/side,/area/ship_salvage/component/c_2_5)
"bC" = (/obj/machinery/atmospherics/components/unary/portables_connector/visible{tag = "icon-connector_map (NORTH)"; icon_state = "connector_map"; dir = 1},/obj/machinery/portable_atmospherics/canister/toxins,/turf/open/floor/plasteel/yellow/side,/area/ship_salvage/component/c_2_5)
"bD" = (/obj/machinery/power/port_gen/pacman,/obj/structure/cable{icon_state = "0-4"; d2 = 4},/turf/open/floor/plasteel/yellow/side,/area/ship_salvage/component/c_2_5)
"bE" = (/obj/machinery/power/smes/engineering,/obj/structure/cable{icon_state = "0-4"; d2 = 4},/obj/structure/cable{d2 = 8; icon_state = "0-8"},/turf/open/floor/plasteel/yellow/side,/area/ship_salvage/component/c_2_5)
"bF" = (/obj/machinery/power/port_gen/pacman,/obj/structure/cable{d2 = 8; icon_state = "0-8"},/turf/open/floor/plasteel/yellow/side,/area/ship_salvage/component/c_2_5)
"bG" = (/obj/machinery/vending/engineering,/turf/open/floor/plasteel/yellow/side,/area/ship_salvage/component/c_2_5)
"bH" = (/obj/machinery/suit_storage_unit/engine,/turf/open/floor/plasteel/yellow/side,/area/ship_salvage/component/c_2_5)
"bI" = (/obj/machinery/suit_storage_unit/engine,/turf/open/floor/plasteel/yellow/side{tag = "icon-yellow (SOUTHEAST)"; icon_state = "yellow"; dir = 6},/area/ship_salvage/component/c_2_5)
"bJ" = (/obj/structure/shuttle/engine/heater,/obj/structure/window/reinforced{dir = 1},/obj/machinery/atmospherics/pipe/simple/general/visible,/turf/open/floor/plating,/area/ship_salvage/component/c_3_5)
"bK" = (/obj/structure/shuttle/engine/propulsion,/turf/open/space,/area/ship_salvage/component/c_1_5)
"bL" = (/obj/structure/shuttle/engine/propulsion,/turf/open/space,/area/ship_salvage/component/c_3_5)

(1,1,1) = {"
aaaaaaaaaaaaaaaaaaaaaaaaaaaaaaaaaaaaaaaaaaaaaaaaaaaaaa
aaaaaaaaaaaaaaaaaaaaaaaaaaaaaaaaaaaaaaaaaaaaaaaaaaaaaa
aaaaaaaaaaaaaaaaababacacacacacacacadadaaaaaaaaaaaaaaaa
aaaaaaaaaaaaaaaaabaeafagagagagagafahadaaaaaaaaaaaaaaaa
aaaaaaaaaaaaaaaaacafafaiaiajaiaiafafacaaaaaaaaaaaaaaaa
aaaaaaaaaaaaaaaaacafaiaiakajalaiaiafacaaaaaaaaaaaaaaaa
aaaaaaaaaaaaaaacacafaialaiajaialaiafacacaaaaaaaaaaaaaa
aaaaaaaaaaaaacacafafaiaiaiajaiaiaiafafacacaaaaaaaaaaaa
aaaaaaaaaaacacafafamamamamanamamamamafafacacaaaaaaaaaa
aaaaaaaaaaacafafaoaoapaqaqaqaqaqarasasafafacaaaaaaaaaa
aaaaaaaaaaacafatatatauaqaqaqaqaqavawawawafacaaaaaaaaaa
aaaaaaaaaaacafatatatauaqaqaqaqaqavawawawafacaaaaaaaaaa
aaaaaaaaaaacafataxatauaqaqaqaqaqavawayawafacaaaaaaaaaa
aaaaaaaaaaacafamamamamamamazamamamamamamafacaaaaaaaaaa
aaaaaaaaaaacaAaBaBaCaCaDaEaEaEaDaFaFaGaGaAacaaaaaaaaaa
aaaaaaaaaaacaAaBaBaCaCaDaEaEaEaDaFaFaGaGaAacaaaaaaaaaa
aaaaaaaaaaacafaHaHaCaCaDaEaEaEaDaFaFaGaIafacaaaaaaaaaa
aaaaaaaaaaacaJaBaKaCaCaLaLaLaLaLaFaFaGaGaAacaaaaaaaaaa
aaaaaaaaaaacaMaNaOaPaPaQaQaQaQaQaRaRaSaSaAacaaaaaaaaaa
aaaaaaaaaaacafaTaTaPaPaUaVaVaVaUaRaRaWaWafacaaaaaaaaaa
aaaaaaaaaaafafaXaXaPaPaUaVaVaVaUaRaRaWaWafafaaaaaaaaaa
aaaaaaaaafafafaXaXaPaPaUaVaVaVaUaRaRaWaWafafafaaaaaaaa
aaaaaaafafafafamamamamamamaYamamamamamamafafafafaaaaaa
aaaaafafaZbabbbcbcbcbcbcbcbdbcbcbcbcbcbcbebfbgafafaaaa
aaaaafbabhbiafbjbkbkbkbkbkblbkbkbkbkbkbmafbnbobfafaaaa
aaaaafbpbpbpafbqbrbrbrbsbtbubtbvbrbrbrbwafbxbxbxafaaaa
aaaaafbybybyafbzbAbAbBbCbDbEbFbCbBbGbHbIafbJbJbJafaaaa
aaaaafbKbKbKafafafafafafafafafafafafafafafbLbLbLafaaaa
aaaaaaaaaaaaaaaaaaaaaaaaaaaaaaaaaaaaaaaaaaaaaaaaaaaaaa
aaaaaaaaaaaaaaaaaaaaaaaaaaaaaaaaaaaaaaaaaaaaaaaaaaaaaa
aaaaaaaaaaaaaaaaaaaaaaaaaaaaaaaaaaaaaaaaaaaaaaaaaaaaaa
aaaaaaaaaaaaaaaaaaaaaaaaaaaaaaaaaaaaaaaaaaaaaaaaaaaaaa
aaaaaaaaaaaaaaaaaaaaaaaaaaaaaaaaaaaaaaaaaaaaaaaaaaaaaa
aaaaaaaaaaaaaaaaaaaaaaaaaaaaaaaaaaaaaaaaaaaaaaaaaaaaaa
"}
