//MAP CONVERTED BY dmm2tgm.py THIS HEADER COMMENT PREVENTS RECONVERSION, DO NOT REMOVE
"a" = (
/turf/open/space,
/area/space)
"b" = (
/turf/closed/wall/mineral/titanium,
/area/ship_salvage/hull)
"d" = (
/obj/machinery/door/airlock/external,
/turf/open/floor/plasteel/shuttle,
/area/ship_salvage/hull)
"e" = (
/obj/structure/table,
/turf/open/floor/plasteel/shuttle,
/area/ship_salvage/hull)
"f" = (
/obj/machinery/computer,
/turf/open/floor/plasteel/shuttle,
/area/ship_salvage/hull)
"g" = (
/obj/structure/closet/emcloset,
/turf/open/floor/plasteel/shuttle,
/area/ship_salvage/hull)
"h" = (
/turf/open/floor/plasteel/shuttle,
/area/ship_salvage/hull)
"i" = (
/obj/structure/chair{
	dir = 1
	},
/obj/effect/mob_spawn/human/corpse/nanotrasensoldier,
/turf/open/floor/plasteel/shuttle,
/area/ship_salvage/hull)
"j" = (
/obj/machinery/door/airlock/command,
/turf/open/floor/plasteel/shuttle,
/area/ship_salvage/hull)
"k" = (
/obj/structure/bed/roller,
/turf/open/floor/plasteel/white,
/area/ship_salvage/hull)
"l" = (
/turf/open/floor/plasteel/white,
/area/ship_salvage/hull)
"m" = (
/obj/structure/bed,
/obj/item/weapon/bedsheet/medical,
/obj/effect/mob_spawn/human/corpse,
/turf/open/floor/plasteel/white,
/area/ship_salvage/hull)
"n" = (
/obj/structure/chair{
	dir = 1
	},
/turf/open/floor/plasteel/shuttle,
/area/ship_salvage/hull)
"o" = (
/obj/structure/chair{
	dir = 1
	},
/obj/effect/mob_spawn/human/corpse,
/turf/open/floor/plasteel/shuttle,
/area/ship_salvage/hull)
"p" = (
/obj/structure/chair{
	dir = 1
	},
/obj/structure/window{
	icon_state = "rwindow";
	dir = 4
	},
/turf/open/floor/plasteel/shuttle,
/area/ship_salvage/hull)
"q" = (
/obj/structure/bed,
/obj/item/weapon/bedsheet/medical,
/turf/open/floor/plasteel/white,
/area/ship_salvage/hull)
"r" = (
/obj/structure/window{
	icon_state = "rwindow";
	dir = 4
	},
/turf/open/floor/plasteel/shuttle,
/area/ship_salvage/hull)
"s" = (
/obj/structure/table,
/obj/item/stack/medical/bruise_pack,
/obj/item/stack/medical/ointment,
/obj/item/stack/medical/gauze,
/turf/open/floor/plasteel/white,
/area/ship_salvage/hull)
"t" = (
/obj/structure/table,
/turf/open/floor/plasteel/white,
/area/ship_salvage/hull)
"u" = (
/obj/machinery/sleeper{
	dir = 4;
	icon_state = "sleeper-open"
	},
/turf/open/floor/plasteel/white,
/area/ship_salvage/hull)
"v" = (
/obj/effect/mob_spawn/human/corpse,
/turf/open/floor/plasteel/white,
/area/ship_salvage/hull)
"w" = (
/obj/machinery/sleeper{
	dir = 8;
	icon_state = "sleeper-open"
	},
/turf/open/floor/plasteel/white,
/area/ship_salvage/hull)
"x" = (
/obj/machinery/door/airlock/engineering,
/turf/open/floor/plating,
/area/ship_salvage/hull)
"y" = (
/obj/machinery/door/airlock/external,
/turf/open/floor/plating,
/area/ship_salvage/hull)
"z" = (
/obj/machinery/atmospherics/pipe/simple/general/visible{
	dir = 6
	},
/turf/open/floor/plating,
/area/ship_salvage/hull)
"A" = (
/obj/machinery/atmospherics/pipe/manifold/general/visible{
	dir = 1
	},
/turf/open/floor/plating,
/area/ship_salvage/hull)
"B" = (
/obj/machinery/atmospherics/pipe/manifold/general/visible{
	dir = 1
	},
/obj/effect/mob_spawn/human/corpse/nanotrasensoldier,
/turf/open/floor/plating,
/area/ship_salvage/hull)
"C" = (
/obj/machinery/atmospherics/pipe/simple/general/visible{
	dir = 4
	},
/turf/open/floor/plating,
/area/ship_salvage/hull)
"D" = (
/obj/machinery/atmospherics/pipe/simple/general/visible{
	dir = 10
	},
/turf/open/floor/plating,
/area/ship_salvage/hull)
"E" = (
/obj/structure/shuttle/engine/heater,
/obj/machinery/atmospherics/pipe/simple/general/visible{
	tag = "icon-intact (NORTH)";
	icon_state = "intact";
	dir = 1
	},
/turf/closed/wall/mineral/titanium,
/area/ship_salvage/hull)
"F" = (
/obj/structure/closet/toolcloset,
/turf/open/floor/plating,
/area/ship_salvage/hull)
"G" = (
/obj/machinery/atmospherics/components/unary/portables_connector{
	dir = 1
	},
/obj/machinery/portable_atmospherics/canister/toxins,
/turf/open/floor/plating,
/area/ship_salvage/hull)
"H" = (
/obj/structure/table,
/obj/item/stack/sheet/metal/five,
/turf/open/floor/plating,
/area/ship_salvage/hull)
"J" = (
/obj/structure/shuttle/engine/propulsion{
	icon_state = "propulsion_l"
	},
/turf/open/space,
/area/ship_salvage/hull)
"K" = (
/obj/structure/shuttle/engine/propulsion,
/turf/open/space,
/area/ship_salvage/hull)

(1,1,1) = {"
a
a
a
a
a
a
a
a
a
a
a
a
a
a
a
"}
(2,1,1) = {"
a
b
b
b
b
b
b
b
b
b
b
y
b
b
a
"}
(3,1,1) = {"
a
b
g
b
h
n
h
n
h
n
b
z
E
J
a
"}
(4,1,1) = {"
a
d
h
d
h
o
h
n
h
o
b
A
E
K
a
"}
(5,1,1) = {"
a
d
h
d
h
n
h
o
h
n
b
B
E
J
a
"}
(6,1,1) = {"
b
b
b
b
h
o
h
n
h
n
b
C
b
b
a
"}
(7,1,1) = {"
b
e
h
b
h
p
r
p
r
p
b
C
F
b
a
"}
(8,1,1) = {"
b
f
i
j
h
h
h
h
h
h
x
A
G
b
a
"}
(9,1,1) = {"
b
e
g
b
g
g
h
h
g
g
b
C
H
b
a
"}
(10,1,1) = {"
b
b
b
b
b
b
h
h
b
b
b
C
b
b
a
"}
(11,1,1) = {"
a
a
a
b
k
k
l
l
u
u
b
A
E
J
a
"}
(12,1,1) = {"
a
a
a
b
l
l
l
l
v
l
b
A
E
K
a
"}
(13,1,1) = {"
a
a
a
b
m
q
s
t
w
w
b
D
E
J
a
"}
(14,1,1) = {"
a
a
a
b
b
b
b
b
b
b
b
y
b
b
a
"}
(15,1,1) = {"
a
a
a
a
a
a
a
a
a
a
a
a
a
a
a
"}
