"aa" = (/turf/template_noop,/area/template_noop)
"ab" = (/obj/structure/lattice,/turf/open/space,/area/ship_salvage/hull)
"ac" = (/obj/structure/lattice/catwalk,/turf/open/space,/area/ship_salvage/component/c_1_2)
"ad" = (/obj/machinery/power/shipweapon{dir = 1},/obj/structure/cable{icon_state = "0-4"; d2 = 4},/turf/open/floor/plating/airless/warnplate/end,/area/ship_salvage/component/c_1_2)
"ae" = (/obj/structure/lattice/catwalk,/obj/structure/cable{d1 = 4; d2 = 8; icon_state = "4-8"},/turf/open/space,/area/ship_salvage/component/c_1_2)
"af" = (/obj/structure/lattice/catwalk,/obj/structure/cable{d1 = 2; d2 = 8; icon_state = "2-8"},/turf/open/space,/area/ship_salvage/hull)
"ag" = (/obj/structure/lattice/catwalk,/obj/structure/cable{d1 = 2; d2 = 4; icon_state = "2-4"},/turf/open/space,/area/ship_salvage/hull)
"ah" = (/obj/machinery/power/shipweapon{dir = 1},/obj/structure/cable{d2 = 8; icon_state = "0-8"},/turf/open/floor/plating/airless/warnplate/end,/area/ship_salvage/component/c_1_2)
"ai" = (/turf/closed/wall/r_wall,/area/ship_salvage/component/c_1_2)
"aj" = (/obj/structure/grille,/obj/structure/window/reinforced/fulltile,/turf/open/floor/plating,/area/ship_salvage/component/c_1_2)
"ak" = (/obj/structure/lattice/catwalk,/obj/structure/cable{d1 = 1; d2 = 2; icon_state = "1-2"; pixel_y = 0},/turf/open/space,/area/ship_salvage/hull)
"al" = (/obj/structure/table,/obj/machinery/cell_charger,/turf/open/floor/plasteel/brown{dir = 8},/area/ship_salvage/component/c_1_2)
"am" = (/turf/open/floor/plasteel,/area/ship_salvage/component/c_1_2)
"an" = (/obj/structure/chair{dir = 1},/turf/open/floor/plasteel,/area/ship_salvage/component/c_1_2)
"ao" = (/obj/structure/closet/firecloset/full,/turf/open/floor/plasteel/brown{dir = 4},/area/ship_salvage/component/c_1_2)
"ap" = (/obj/structure/lattice/catwalk,/obj/structure/cable{d1 = 1; d2 = 2; icon_state = "1-2"; pixel_y = 0},/obj/structure/cable{d1 = 1; d2 = 2; icon_state = "1-2"; pixel_y = 0},/turf/open/space,/area/ship_salvage/hull)
"aq" = (/turf/closed/wall,/area/ship_salvage/component/c_1_2)
"ar" = (/obj/structure/closet/firecloset/full,/turf/open/floor/plasteel/brown{dir = 8},/area/ship_salvage/component/c_1_2)
"as" = (/mob/living/simple_animal/hostile/nanotrasen/ranged,/turf/open/floor/plasteel,/area/ship_salvage/component/c_1_2)
"at" = (/obj/structure/table,/obj/machinery/cell_charger,/turf/open/floor/plasteel/brown{dir = 4},/area/ship_salvage/component/c_1_2)
"au" = (/obj/structure/table,/obj/item/weapon/stock_parts/cell/high/plus,/turf/open/floor/plasteel/brown{dir = 8},/area/ship_salvage/component/c_1_2)
"av" = (/mob/living/simple_animal/hostile/nanotrasen,/turf/open/floor/plasteel,/area/ship_salvage/component/c_1_2)
"aw" = (/obj/effect/spawner/lootdrop/crate_spawner,/turf/open/floor/plasteel/brown{dir = 4},/area/ship_salvage/component/c_1_2)
"ax" = (/obj/effect/spawner/lootdrop/salvage_spawner,/turf/open/floor/plasteel/brown{dir = 8},/area/ship_salvage/component/c_1_2)
"ay" = (/obj/structure/table,/obj/item/weapon/stock_parts/cell/bluespace,/turf/open/floor/plasteel/brown{dir = 4},/area/ship_salvage/component/c_1_2)
"az" = (/turf/closed/wall/r_wall,/area/ship_salvage/component/c_2_2)
"aA" = (/turf/closed/wall,/area/ship_salvage/component/c_2_2)
"aB" = (/obj/machinery/door/airlock/centcom,/turf/open/space,/area/ship_salvage/component/c_2_2)
"aC" = (/obj/structure/lattice/catwalk,/obj/structure/cable{d1 = 1; d2 = 4; icon_state = "1-4"},/turf/open/space,/area/ship_salvage/hull)
"aD" = (/obj/structure/lattice/catwalk,/obj/structure/cable{d1 = 4; d2 = 8; icon_state = "4-8"},/turf/open/space,/area/ship_salvage/hull)
"aE" = (/obj/structure/lattice/catwalk,/obj/structure/cable{d1 = 2; d2 = 8; icon_state = "2-8"},/obj/structure/cable{d1 = 1; d2 = 2; icon_state = "1-2"; pixel_y = 0},/turf/open/space,/area/ship_salvage/hull)
"aF" = (/obj/structure/closet/emcloset,/turf/open/floor/plasteel/red/side{dir = 9},/area/ship_salvage/component/c_2_2)
"aG" = (/turf/open/floor/plasteel/stairs,/area/ship_salvage/component/c_2_2)
"aH" = (/obj/structure/window/reinforced{dir = 8},/obj/structure/closet/gimmick/tacticool,/obj/item/weapon/book/manual/detective,/turf/open/floor/plasteel/red,/area/ship_salvage/component/c_2_2)
"aI" = (/obj/effect/spawner/lootdrop/raresalvage_spawner,/turf/open/floor/plasteel/red,/area/ship_salvage/component/c_2_2)
"aJ" = (/obj/structure/grille,/obj/structure/window/reinforced/fulltile,/turf/open/floor/plating,/area/ship_salvage/component/c_2_2)
"aK" = (/obj/structure/lattice/catwalk,/turf/open/space,/area/ship_salvage/hull)
"aL" = (/obj/machinery/door/airlock/glass_external,/turf/open/floor/plasteel,/area/ship_salvage/component/c_2_2)
"aM" = (/obj/structure/cable{d1 = 2; d2 = 8; icon_state = "2-8"},/turf/open/floor/plasteel/darkwarning{dir = 5},/area/ship_salvage/component/c_2_2)
"aN" = (/obj/machinery/suit_storage_unit/standard_unit,/turf/open/floor/plasteel/blue/side{dir = 8},/area/ship_salvage/component/c_2_2)
"aO" = (/turf/open/floor/plasteel/red/side{dir = 8},/area/ship_salvage/component/c_2_2)
"aP" = (/turf/open/floor/plasteel/neutral,/area/ship_salvage/component/c_2_2)
"aQ" = (/obj/machinery/door/window{dir = 8; name = "Tool Storage"; req_access_txt = "150"},/turf/open/floor/plasteel/red,/area/ship_salvage/component/c_2_2)
"aR" = (/turf/open/floor/plasteel/red,/area/ship_salvage/component/c_2_2)
"aS" = (/obj/structure/cable{d1 = 1; d2 = 2; icon_state = "1-2"; pixel_y = 0},/turf/open/floor/plasteel/darkwarning/side,/area/ship_salvage/component/c_2_2)
"aT" = (/turf/open/floor/plasteel/whiteblue,/area/ship_salvage/component/c_2_2)
"aU" = (/obj/effect/spawner/lootdrop/salvage_spawner,/turf/open/floor/plasteel/blue/side{dir = 8},/area/ship_salvage/component/c_2_2)
"aV" = (/obj/structure/window/reinforced{dir = 8},/obj/structure/closet/secure_closet/hos,/obj/item/weapon/suppressor,/obj/item/weapon/storage/lockbox/clusterbang,/turf/open/floor/plasteel/red,/area/ship_salvage/component/c_2_2)
"aW" = (/obj/structure/lattice,/turf/open/space,/area/ship_salvage/component/c_3_2)
"aX" = (/obj/machinery/door/airlock/glass_external,/obj/structure/cable{d1 = 1; d2 = 2; icon_state = "1-2"; pixel_y = 0},/turf/open/floor/plasteel,/area/ship_salvage/component/c_2_2)
"aY" = (/turf/open/floor/plasteel/blue/side{dir = 8},/area/ship_salvage/component/c_2_2)
"aZ" = (/obj/item/weapon/twohanded/required/ctf,/turf/open/floor/plasteel/red/side{dir = 8},/area/ship_salvage/component/c_2_2)
"ba" = (/obj/structure/window/reinforced,/obj/structure/window/reinforced{dir = 8},/obj/machinery/mech_bay_recharge_port,/turf/open/floor/plasteel/red,/area/ship_salvage/component/c_2_2)
"bb" = (/obj/structure/window/reinforced{dir = 4},/turf/template_noop,/area/template_noop)
"bc" = (/obj/structure/window/reinforced{dir = 8},/turf/template_noop,/area/template_noop)
"bd" = (/obj/structure/cable{d1 = 1; d2 = 4; icon_state = "1-4"},/turf/open/floor/plasteel/stairs,/area/ship_salvage/component/c_2_2)
"be" = (/obj/structure/cable{d1 = 2; d2 = 8; icon_state = "2-8"},/turf/open/floor/plasteel/whiteblue,/area/ship_salvage/component/c_2_2)
"bf" = (/obj/structure/closet/emcloset,/obj/item/weapon/storage/firstaid/fire,/obj/item/weapon/storage/firstaid/brute,/turf/open/floor/plasteel/blue/side{dir = 8},/area/ship_salvage/component/c_2_2)
"bg" = (/obj/structure/table/reinforced,/obj/item/stack/sheet/metal/fifty,/obj/item/weapon/reagent_containers/spray/pepper,/turf/open/floor/plasteel/red/side{dir = 8},/area/ship_salvage/component/c_2_2)
"bh" = (/obj/structure/closet/secure_closet/security,/turf/open/floor/plasteel/red/side{dir = 4},/area/ship_salvage/component/c_2_2)
"bi" = (/turf/closed/wall/r_wall,/area/ship_salvage/component/c_3_2)
"bj" = (/obj/machinery/mac_barrel,/obj/structure/plasticflaps{opacity = 1},/turf/open/floor/plasteel/warning/end,/area/ship_salvage/component/c_3_2)
"bk" = (/turf/open/floor/plasteel/blue/side{dir = 4},/area/ship_salvage/component/c_2_2)
"bl" = (/obj/structure/cable{d1 = 1; d2 = 2; icon_state = "1-2"; pixel_y = 0},/turf/open/floor/plasteel/whiteblue,/area/ship_salvage/component/c_2_2)
"bm" = (/obj/machinery/sleeper{icon_state = "sleeper-open"; dir = 8},/turf/open/floor/plasteel/blue/side{dir = 8},/area/ship_salvage/component/c_2_2)
"bn" = (/obj/structure/table/reinforced,/obj/item/weapon/storage/toolbox,/turf/open/floor/plasteel/red/side{dir = 8},/area/ship_salvage/component/c_2_2)
"bo" = (/mob/living/simple_animal/hostile/nanotrasen/ranged/smg,/turf/open/floor/plasteel/neutral,/area/ship_salvage/component/c_2_2)
"bp" = (/obj/item/trash/chips,/turf/open/floor/plasteel/neutral,/area/ship_salvage/component/c_2_2)
"bq" = (/obj/machinery/ammo_rack/full,/turf/open/floor/plasteel/neutral,/area/ship_salvage/component/c_3_2)
"br" = (/obj/structure/window{icon_state = "window"; dir = 4},/obj/machinery/ammo_rack/full/shield_piercing,/turf/open/floor/plasteel/neutral,/area/ship_salvage/component/c_3_2)
"bs" = (/obj/machinery/mac_breech,/turf/open/floor/plasteel/neutral,/area/ship_salvage/component/c_3_2)
"bt" = (/obj/structure/window{icon_state = "window"; dir = 8},/turf/open/floor/plasteel/neutral,/area/ship_salvage/component/c_3_2)
"bu" = (/obj/machinery/computer/munitions_console,/turf/open/floor/plasteel/neutral,/area/ship_salvage/component/c_3_2)
"bv" = (/obj/machinery/vending/medical,/turf/open/floor/plasteel/blue/side{dir = 4},/area/ship_salvage/component/c_2_2)
"bw" = (/mob/living/simple_animal/hostile/nanotrasen/ranged/smg,/turf/open/floor/plasteel/whiteblue,/area/ship_salvage/component/c_2_2)
"bx" = (/obj/structure/table/reinforced,/obj/item/weapon/twohanded/required/chainsaw,/obj/item/stack/sheet/glass/fifty,/turf/open/floor/plasteel/red/side{dir = 8},/area/ship_salvage/component/c_2_2)
"by" = (/obj/machinery/vending/security,/turf/open/floor/plasteel/red/side{dir = 4},/area/ship_salvage/component/c_2_2)
"bz" = (/turf/open/floor/plasteel/loadingarea{dir = 4},/area/ship_salvage/component/c_3_2)
"bA" = (/mob/living/simple_animal/hostile/nanotrasen,/turf/open/floor/plasteel/loadingarea{dir = 4},/area/ship_salvage/component/c_3_2)
"bB" = (/obj/structure/window/reinforced,/obj/structure/shell,/turf/open/floor/plasteel/loadingarea{dir = 1},/area/ship_salvage/component/c_3_2)
"bC" = (/turf/open/floor/plasteel/neutral,/area/ship_salvage/component/c_3_2)
"bD" = (/obj/item/weapon/twohanded/required/shell_casing,/obj/structure/chair{dir = 1},/turf/open/floor/plasteel/neutral,/area/ship_salvage/component/c_3_2)
"bE" = (/obj/structure/bed/roller,/turf/open/floor/plasteel/blue/side{dir = 4},/area/ship_salvage/component/c_2_2)
"bF" = (/turf/open/floor/plasteel/red/side{dir = 4},/area/ship_salvage/component/c_2_2)
"bG" = (/obj/structure/closet/bombcloset,/turf/open/floor/plasteel/neutral,/area/ship_salvage/component/c_3_2)
"bH" = (/obj/item/weapon/twohanded/required/shell_casing,/turf/open/floor/plasteel/neutral,/area/ship_salvage/component/c_3_2)
"bI" = (/obj/machinery/computer/crew,/turf/open/floor/plasteel/blue/side{dir = 4},/area/ship_salvage/component/c_2_2)
"bJ" = (/obj/structure/table,/obj/item/weapon/storage/firstaid/tactical,/obj/item/weapon/storage/firstaid/regular,/turf/open/floor/plasteel/blue/side{dir = 8},/area/ship_salvage/component/c_2_2)
"bK" = (/obj/machinery/autolathe,/turf/open/floor/plasteel/red/side{dir = 10},/area/ship_salvage/component/c_2_2)
"bL" = (/turf/open/floor/plasteel/red/side,/area/ship_salvage/component/c_2_2)
"bM" = (/turf/open/floor/plasteel/red/side{dir = 6},/area/ship_salvage/component/c_2_2)
"bN" = (/turf/closed/wall/r_wall,/area/ship_salvage/component/c_2_1)
"bO" = (/turf/closed/wall,/area/ship_salvage/component/c_2_1)
"bP" = (/obj/machinery/door/airlock/centcom,/turf/open/space,/area/ship_salvage/component/c_2_1)
"bQ" = (/obj/structure/closet/secure_closet/ertMed,/turf/open/floor/plasteel/blue/side{dir = 4},/area/ship_salvage/component/c_2_2)
"bR" = (/obj/structure/table,/obj/machinery/computer/med_data/laptop,/turf/open/floor/plasteel/blue/side{dir = 8},/area/ship_salvage/component/c_2_2)
"bS" = (/obj/machinery/computer/ftl_navigation,/turf/open/floor/plasteel/darkblue/corner,/area/ship_salvage/component/c_2_1)
"bT" = (/turf/open/floor/plasteel/darkblue,/area/ship_salvage/component/c_2_1)
"bU" = (/obj/machinery/computer/ftl_weapons,/turf/open/floor/plasteel/darkblue,/area/ship_salvage/component/c_2_1)
"bV" = (/obj/structure/closet/emcloset,/obj/item/device/aicard,/turf/open/floor/plasteel/darkblue/corner{dir = 8},/area/ship_salvage/component/c_2_1)
"bW" = (/obj/machinery/door/airlock/centcom,/obj/structure/cable{d1 = 1; d2 = 2; icon_state = "1-2"; pixel_y = 0},/turf/open/space,/area/ship_salvage/component/c_2_2)
"bX" = (/obj/structure/bed,/obj/item/weapon/bedsheet/blue,/turf/open/floor/plasteel/arrival{dir = 1},/area/ship_salvage/component/c_2_2)
"bY" = (/obj/structure/table,/obj/item/weapon/book/random,/obj/effect/spawner/lootdrop/gambling,/turf/open/floor/plasteel/arrival{dir = 1},/area/ship_salvage/component/c_2_2)
"bZ" = (/obj/structure/chair{dir = 1},/turf/open/floor/plasteel/darkblue,/area/ship_salvage/component/c_2_1)
"ca" = (/obj/structure/table,/obj/machinery/microwave,/obj/item/weapon/storage/box/donkpockets,/turf/open/floor/plasteel/arrival{dir = 1},/area/ship_salvage/component/c_2_2)
"cb" = (/obj/structure/cable{d1 = 1; d2 = 2; icon_state = "1-2"; pixel_y = 0},/turf/open/floor/plasteel/stairs,/area/ship_salvage/component/c_2_2)
"cc" = (/turf/open/floor/plasteel,/area/ship_salvage/component/c_2_2)
"cd" = (/obj/structure/cable{d1 = 2; d2 = 4; icon_state = "2-4"},/turf/open/floor/plasteel/darkblue,/area/ship_salvage/component/c_2_1)
"ce" = (/obj/machinery/computer/communications,/obj/structure/cable{d1 = 4; d2 = 8; icon_state = "4-8"},/turf/open/floor/plasteel/darkblue,/area/ship_salvage/component/c_2_1)
"cf" = (/obj/structure/cable{d1 = 4; d2 = 8; icon_state = "4-8"},/turf/open/floor/plasteel/darkblue,/area/ship_salvage/component/c_2_1)
"cg" = (/obj/machinery/door/airlock/centcom,/obj/structure/cable{d1 = 4; d2 = 8; icon_state = "4-8"},/turf/open/space,/area/ship_salvage/component/c_2_1)
"ch" = (/obj/structure/cable{d1 = 4; d2 = 8; icon_state = "4-8"},/turf/open/floor/plasteel,/area/ship_salvage/component/c_2_2)
"ci" = (/obj/structure/cable{d1 = 1; d2 = 8; icon_state = "1-8"},/turf/open/floor/plasteel,/area/ship_salvage/component/c_2_2)
"cj" = (/obj/structure/closet/wardrobe/mixed,/turf/open/floor/plasteel/arrival,/area/ship_salvage/component/c_2_2)
"ck" = (/obj/structure/bed,/obj/item/weapon/bedsheet/blue,/turf/open/floor/plasteel/arrival,/area/ship_salvage/component/c_2_2)
"cl" = (/obj/machinery/computer/security,/turf/open/floor/plasteel/darkblue,/area/ship_salvage/component/c_2_1)
"cm" = (/obj/structure/cable{d1 = 1; d2 = 2; icon_state = "1-2"; pixel_y = 0},/turf/open/floor/plasteel/darkblue,/area/ship_salvage/component/c_2_1)
"cn" = (/obj/structure/chair/comfy/black{dir = 1},/mob/living/simple_animal/hostile/nanotrasen,/turf/open/floor/plasteel/darkblue,/area/ship_salvage/component/c_2_1)
"co" = (/obj/machinery/computer/crew,/turf/open/floor/plasteel/darkblue,/area/ship_salvage/component/c_2_1)
"cp" = (/obj/structure/closet/wardrobe/mixed,/obj/item/weapon/reagent_containers/spray/cleaner,/turf/open/floor/plasteel/arrival,/area/ship_salvage/component/c_2_2)
"cq" = (/obj/structure/chair{dir = 1},/turf/open/floor/plasteel/darkblue/corner{dir = 4},/area/ship_salvage/component/c_2_1)
"cr" = (/obj/structure/chair{dir = 1},/turf/open/floor/plasteel/darkblue/corner{dir = 1},/area/ship_salvage/component/c_2_1)
"cs" = (/obj/structure/shuttle/engine/propulsion,/turf/open/floor/plating/airless,/area/ship_salvage/component/c_3_3)
"ct" = (/obj/machinery/door/airlock/centcom,/obj/structure/cable{d1 = 1; d2 = 2; icon_state = "1-2"; pixel_y = 0},/turf/open/space,/area/ship_salvage/component/c_2_1)
"cu" = (/turf/closed/wall/r_wall,/area/ship_salvage/component/c_2_3)
"cv" = (/obj/machinery/power/smes/engineering,/turf/open/floor/plasteel/yellow/side{dir = 4},/area/ship_salvage/component/c_2_3)
"cw" = (/obj/structure/cable{d1 = 1; d2 = 2; icon_state = "1-2"; pixel_y = 0},/turf/open/floor/plasteel/whiteyellow,/area/ship_salvage/component/c_2_3)
"cx" = (/turf/open/floor/plasteel/whiteyellow,/area/ship_salvage/component/c_2_3)
"cy" = (/turf/open/floor/plasteel/yellow/side{dir = 8},/area/ship_salvage/component/c_2_3)
"cz" = (/obj/structure/closet/crate/secure/engineering,/obj/structure/cable{icon_state = "0-2"; d2 = 2},/turf/open/floor/plasteel/yellow/side{dir = 4},/area/ship_salvage/component/c_2_3)
"cA" = (/obj/machinery/vending/engineering,/obj/structure/cable{d1 = 1; d2 = 4; icon_state = "1-4"},/turf/open/floor/plasteel/yellow/side{dir = 4},/area/ship_salvage/component/c_2_3)
"cB" = (/obj/structure/cable{d1 = 2; d2 = 8; icon_state = "2-8"},/obj/structure/cable{d1 = 1; d2 = 8; icon_state = "1-8"},/turf/open/floor/plasteel/whiteyellow,/area/ship_salvage/component/c_2_3)
"cC" = (/obj/machinery/ftl_shieldgen,/obj/machinery/atmospherics/pipe/simple/general/visible,/obj/structure/cable{icon_state = "0-2"; d2 = 2},/turf/open/floor/plasteel/whiteyellow,/area/ship_salvage/component/c_2_3)
"cD" = (/obj/structure/grille,/obj/structure/window/reinforced/fulltile,/turf/open/floor/plating,/area/ship_salvage/component/c_1_3)
"cE" = (/obj/machinery/portable_atmospherics/canister/toxins,/obj/machinery/atmospherics/components/unary/portables_connector/visible{dir = 4},/turf/open/floor/plasteel/yellow/side{dir = 4},/area/ship_salvage/component/c_1_3)
"cF" = (/obj/machinery/atmospherics/pipe/manifold/general/visible{dir = 1},/obj/structure/cable{d1 = 1; d2 = 2; icon_state = "1-2"; pixel_y = 0},/obj/structure/cable{d1 = 1; d2 = 4; icon_state = "1-4"},/mob/living/simple_animal/hostile/nanotrasen/ranged,/turf/open/floor/plasteel/whiteyellow,/area/ship_salvage/component/c_2_3)
"cG" = (/obj/machinery/atmospherics/pipe/simple/general/visible{dir = 4},/obj/structure/cable{d1 = 4; d2 = 8; icon_state = "4-8"},/turf/open/floor/plasteel/whiteyellow,/area/ship_salvage/component/c_2_3)
"cH" = (/obj/machinery/atmospherics/pipe/manifold/general/visible{dir = 4; initialize_directions = 11},/obj/structure/cable{d1 = 1; d2 = 8; icon_state = "1-8"},/obj/structure/cable{d1 = 2; d2 = 8; icon_state = "2-8"},/turf/open/floor/plasteel/whiteyellow,/area/ship_salvage/component/c_2_3)
"cI" = (/obj/machinery/atmospherics/components/unary/portables_connector/visible{dir = 4},/obj/effect/spawner/lootdrop/salvage_spawner,/turf/open/floor/plasteel/yellow/side{dir = 4},/area/ship_salvage/component/c_1_3)
"cJ" = (/obj/machinery/atmospherics/pipe/manifold/general/visible{dir = 4; initialize_directions = 11},/obj/structure/cable{d1 = 1; d2 = 2; icon_state = "1-2"; pixel_y = 0},/turf/open/floor/plasteel/whiteyellow,/area/ship_salvage/component/c_2_3)
"cK" = (/obj/machinery/atmospherics/pipe/simple/general/visible,/obj/structure/cable,/turf/open/floor/plasteel/whiteyellow,/area/ship_salvage/component/c_2_3)
"cL" = (/obj/machinery/atmospherics/pipe/manifold/general/visible{dir = 4; initialize_directions = 11},/obj/structure/cable{d1 = 1; d2 = 2; icon_state = "1-2"; pixel_y = 0},/obj/effect/spawner/lootdrop/maintenance,/turf/open/floor/plasteel/whiteyellow,/area/ship_salvage/component/c_2_3)
"cM" = (/obj/machinery/ftl_drive,/obj/machinery/atmospherics/pipe/simple/general/visible,/turf/open/floor/plasteel/whiteyellow,/area/ship_salvage/component/c_2_3)
"cN" = (/turf/closed/wall/r_wall,/area/ship_salvage/component/c_1_3)
"cO" = (/obj/structure/window/reinforced{dir = 1},/obj/structure/shuttle/engine/heater,/obj/machinery/atmospherics/pipe/simple/general/visible{dir = 4},/turf/open/floor/plating/airless,/area/ship_salvage/component/c_1_3)
"cP" = (/obj/structure/window/reinforced{dir = 1},/obj/structure/shuttle/engine/heater,/obj/machinery/atmospherics/pipe/manifold/general/visible{dir = 4; initialize_directions = 11},/turf/open/floor/plating/airless,/area/ship_salvage/component/c_1_3)
"cQ" = (/obj/structure/shuttle/engine/propulsion,/turf/open/floor/plating/airless,/area/ship_salvage/component/c_1_3)

(1,1,1) = {"
aaaaabaaabaaaaaaaaaaaaaaaaaaaaaaabaaabaaaa
aaaaabaaabaaaaaaaaaaaaaaaaaaaaaaabaaabaaaa
aaaaacadaeaeafaaaaaaaaaaaaaaagaeaeahacaaaa
aiaiaiajaiaiakaaaaaaaaaaaaaaakaiaiajaiaiai
aialamanaoaiakaaaaaaaaaaaaaaapaqaranasataq
aiauavamawaiakaaaaaaaaaaaaaaakaqaxamamayaq
azaAaBaAaAazaCaDaDaDaDaDaDaDaEazaAaAaBaAaz
azaFaGaHaIaJaKaaaaaaaaaaaaaaaCaLaMaAaGaNaz
azaOaPaQaRaJaKaaaaaaaaaaaaaaaKazaSaAaTaUaz
azaOaPaVaRaJaKaaaaaaaWaaaaaaaKazaXaAaTaYaz
azaZaPbaaIazaaaaaabbaWbcaaaaaaazbdbeaTbfaz
aJbgaPaPbhazaabibibibjbibibiaaazbkblaTbmaJ
aJbnbobpbhazaabibqbrbsbtbubiaaazbvblbwaYaJ
aJbxaPaPbyazaabibzbAbBbCbDbiaaazbEblaTbmaJ
azaOaPaPbFazaabibGbHbCbCbCbiaaazbIblaTbJaz
azbKbLbLbMazaabNbObObObPbObNaaazbQblaTbRaz
azazazaBaAazaJbNbSbTbUbTbVbNaJazaAbWazazaz
aaaaazaGbXbYbXbObZbTbZbTbTbObXcabXcbazaaaa
aaaaazccccccccbPbTcdcecfcfcgchchchciazaaaa
aaaaazcjckcjckbOclcmcnbTcobOckcpckcjazaaaa
aaaaazazaJaJazbNcqcmbTbTcrbNazaJaJazazaaaa
aaaaaacscsaaaabNbOctbObObObNaaaacscsaaaaaa
aaaaaaaaaaaaaacucvcwcxcxcycuaaaaaaaaaaaaaa
aaaaaaaaaaaaaacuczcwcxcxcycuaaaaaaaaaaaaaa
aaaaaaaaaaaaaacucAcBcxcCcycuaaaaaaaaaaaaaa
aaaaaaaaaaaaaacDcEcFcGcHcycuaaaaaaaaaaaaaa
aaaaaaaaaaaaaacDcIcJcxcKcycuaaaaaaaaaaaaaa
aaaaaaaaaaaaaacDcEcLcxcMcycuaaaaaaaaaaaaaa
aaaaaaaaaaaaaacNcOcPcOcOcOcNaaaaaaaaaaaaaa
aaaaaaaaaaaaaaaacQcQcQcQcQaaaaaaaaaaaaaaaa
"}
