"aa" = (/turf/template_noop,/area/template_noop)
"ab" = (/obj/structure/grille,/obj/structure/window/reinforced/fulltile,/turf/open/floor/plating,/area/ship_salvage/component/c_2_2)
"ac" = (/turf/closed/wall,/area/ship_salvage/component/c_2_2)
"ad" = (/obj/structure/table,/turf/open/floor/plasteel/sepia,/area/ship_salvage/component/c_2_2)
"ae" = (/obj/machinery/computer/communications,/turf/open/floor/plasteel/sepia,/area/ship_salvage/component/c_2_2)
"af" = (/obj/machinery/computer/crew,/turf/open/floor/plasteel/sepia,/area/ship_salvage/component/c_2_2)
"ag" = (/obj/structure/table,/obj/effect/spawner/lootdrop/gambling,/turf/open/floor/plasteel/sepia,/area/ship_salvage/component/c_2_2)
"ah" = (/obj/machinery/computer/cargo,/turf/open/floor/plasteel/sepia,/area/ship_salvage/component/c_2_2)
"ai" = (/turf/open/floor/plasteel/sepia,/area/ship_salvage/component/c_2_2)
"aj" = (/obj/structure/chair{dir = 1},/turf/open/floor/plasteel/sepia,/area/ship_salvage/component/c_2_2)
"ak" = (/obj/machinery/computer/ftl_navigation,/turf/open/floor/plasteel/sepia,/area/ship_salvage/component/c_2_2)
"al" = (/obj/machinery/light/built,/turf/open/floor/plasteel/sepia,/area/ship_salvage/component/c_2_2)
"am" = (/turf/closed/wall,/area/ship_salvage/hull)
"an" = (/obj/structure/closet/emcloset,/turf/open/floor/plasteel/sepia,/area/ship_salvage/component/c_2_2)
"ao" = (/turf/closed/wall/rust,/area/ship_salvage/component/c_1_1)
"ap" = (/obj/structure/lattice,/obj/machinery/power/smes,/turf/open/space,/area/ship_salvage/hull)
"aq" = (/obj/structure/cable{d1 = 2; d2 = 4; icon_state = "2-4"},/turf/open/floor/plasteel/sepia,/area/ship_salvage/component/c_2_2)
"ar" = (/obj/structure/table,/obj/machinery/microwave,/obj/structure/cable{d2 = 8; icon_state = "0-8"},/turf/open/floor/plasteel/sepia,/area/ship_salvage/component/c_2_2)
"as" = (/obj/effect/spawner/lootdrop/raresalvage_spawner,/turf/open/floor/pod/dark,/area/ship_salvage/component/c_1_1)
"at" = (/obj/structure/closet/crate/secure/loot,/turf/open/floor/pod/dark,/area/ship_salvage/component/c_1_1)
"au" = (/obj/structure/lattice,/obj/structure/cable{d2 = 2; icon_state = "0-2"},/turf/open/space,/area/ship_salvage/hull)
"av" = (/obj/structure/cable{d1 = 1; d2 = 2; icon_state = "1-2"},/turf/open/floor/plasteel/sepia,/area/ship_salvage/component/c_2_2)
"aw" = (/obj/structure/table,/obj/item/weapon/storage/box/donkpockets,/obj/machinery/light/built,/turf/open/floor/plasteel/sepia,/area/ship_salvage/component/c_2_2)
"ax" = (/obj/structure/closet/crate/internals,/turf/open/floor/pod/dark,/area/ship_salvage/component/c_1_1)
"ay" = (/obj/structure/lattice,/obj/machinery/porta_turret/syndicate/pod,/turf/open/space,/area/ship_salvage/component/c_2_1)
"az" = (/turf/open/floor/pod/dark,/area/ship_salvage/component/c_1_1)
"aA" = (/obj/machinery/light/small/built,/turf/open/floor/pod/dark,/area/ship_salvage/component/c_1_1)
"aB" = (/obj/machinery/door/airlock/hatch,/turf/open/floor/pod/dark,/area/ship_salvage/component/c_1_1)
"aC" = (/obj/structure/lattice/catwalk,/obj/structure/cable{d1 = 1; d2 = 2; icon_state = "1-2"},/turf/open/space,/area/ship_salvage/hull)
"aD" = (/turf/closed/wall,/area/ship_salvage/component/c_1_3)
"aE" = (/obj/machinery/door/airlock/external,/turf/open/floor/plasteel/sepia,/area/ship_salvage/component/c_1_3)
"aF" = (/obj/machinery/light/small/built,/obj/machinery/portable_atmospherics/canister/agent_b,/turf/open/floor/pod/dark,/area/ship_salvage/component/c_1_1)
"aG" = (/obj/structure/lattice/catwalk,/obj/machinery/atmospherics/pipe/simple/general/visible{dir = 6},/turf/open/space,/area/ship_salvage/component/c_2_3)
"aH" = (/obj/structure/lattice,/obj/machinery/atmospherics/pipe/simple/general/visible{dir = 10},/turf/open/space,/area/ship_salvage/component/c_2_1)
"aI" = (/obj/structure/grille,/obj/structure/window/reinforced/fulltile,/turf/open/floor/plating,/area/ship_salvage/component/c_1_3)
"aJ" = (/obj/structure/cable{d1 = 1; d2 = 2; icon_state = "1-2"},/turf/open/floor/plasteel/sepia,/area/ship_salvage/component/c_1_3)
"aK" = (/obj/machinery/suit_storage_unit/mining/eva,/turf/open/floor/plasteel/sepia,/area/ship_salvage/component/c_1_3)
"aL" = (/obj/structure/lattice,/obj/machinery/atmospherics/pipe/simple/general/visible{dir = 6},/turf/open/space,/area/ship_salvage/component/c_2_1)
"aM" = (/obj/structure/lattice/catwalk,/obj/machinery/atmospherics/pipe/simple/general/visible{dir = 10},/turf/open/space,/area/ship_salvage/component/c_2_3)
"aN" = (/obj/structure/shuttle/engine/heater,/obj/structure/window/reinforced{dir = 1},/obj/machinery/atmospherics/pipe/simple/general/visible,/turf/closed/wall,/area/ship_salvage/component/c_2_3)
"aO" = (/obj/structure/lattice,/obj/machinery/atmospherics/pipe/simple/general/visible{dir = 5},/obj/structure/cable{d1 = 4; d2 = 8; icon_state = "4-8"},/turf/open/space,/area/ship_salvage/hull)
"aP" = (/obj/structure/lattice,/obj/machinery/atmospherics/pipe/simple/general/visible{dir = 4},/obj/structure/cable{d1 = 4; d2 = 8; icon_state = "4-8"},/turf/open/space,/area/ship_salvage/hull)
"aQ" = (/obj/structure/lattice/catwalk,/obj/machinery/atmospherics/pipe/simple/general/visible{dir = 4},/obj/structure/cable{d1 = 4; d2 = 8; icon_state = "4-8"},/turf/open/space,/area/ship_salvage/hull)
"aR" = (/obj/structure/lattice/catwalk,/obj/machinery/atmospherics/pipe/simple/general/visible{dir = 10},/obj/structure/cable{d1 = 1; d2 = 4; icon_state = "1-4"},/obj/structure/cable{d1 = 1; d2 = 8; icon_state = "1-8"},/turf/open/space,/area/ship_salvage/hull)
"aS" = (/obj/machinery/door/airlock/external{req_access_txt = "150"},/obj/structure/cable{d1 = 4; d2 = 8; icon_state = "4-8"},/turf/open/floor/pod/dark,/area/ship_salvage/component/c_1_3)
"aT" = (/obj/structure/cable{d1 = 4; d2 = 8; icon_state = "4-8"},/obj/structure/cable{d1 = 1; d2 = 8; icon_state = "1-8"},/obj/structure/cable{d1 = 2; d2 = 8; icon_state = "2-8"},/turf/open/floor/plasteel/sepia,/area/ship_salvage/component/c_1_3)
"aU" = (/obj/structure/cable{d1 = 4; d2 = 8; icon_state = "4-8"},/turf/open/floor/plasteel/sepia,/area/ship_salvage/component/c_1_3)
"aV" = (/obj/structure/lattice/catwalk,/obj/machinery/atmospherics/pipe/simple/general/visible{dir = 6},/obj/structure/cable{d1 = 1; d2 = 8; icon_state = "1-8"},/obj/structure/cable{d1 = 1; d2 = 4; icon_state = "1-4"},/turf/open/space,/area/ship_salvage/hull)
"aW" = (/obj/structure/lattice,/obj/machinery/atmospherics/pipe/simple/general/visible{dir = 9},/obj/structure/cable{d1 = 4; d2 = 8; icon_state = "4-8"},/turf/open/space,/area/ship_salvage/hull)
"aX" = (/obj/structure/shuttle/engine/propulsion,/obj/structure/lattice/catwalk,/turf/open/space,/area/ship_salvage/component/c_2_3)
"aY" = (/obj/structure/lattice,/turf/open/space,/area/ship_salvage/hull)
"aZ" = (/turf/closed/wall/rust,/area/ship_salvage/component/c_3_2)
"ba" = (/obj/structure/lattice/catwalk,/obj/machinery/atmospherics/pipe/simple/general/visible,/turf/open/space,/area/ship_salvage/hull)
"bb" = (/obj/structure/closet/firecloset,/obj/machinery/light/built,/turf/open/floor/plasteel/sepia,/area/ship_salvage/component/c_1_3)
"bc" = (/turf/closed/wall/rust,/area/ship_salvage/component/c_3_1)
"bd" = (/obj/structure/lattice/catwalk,/turf/open/space,/area/ship_salvage/component/c_2_3)
"be" = (/obj/effect/spawner/lootdrop/salvage_spawner,/turf/open/floor/pod/dark,/area/ship_salvage/component/c_3_2)
"bf" = (/turf/open/floor/pod/dark,/area/ship_salvage/component/c_3_2)
"bg" = (/obj/machinery/door/airlock/hatch,/turf/open/floor/pod/dark,/area/ship_salvage/component/c_3_2)
"bh" = (/obj/machinery/door/airlock/external,/obj/structure/cable{d1 = 1; d2 = 2; icon_state = "1-2"},/turf/open/floor/plasteel/sepia,/area/ship_salvage/component/c_1_3)
"bi" = (/obj/machinery/door/airlock/hatch,/turf/open/floor/pod/dark,/area/ship_salvage/component/c_3_1)
"bj" = (/turf/open/floor/pod/dark,/area/ship_salvage/component/c_3_1)
"bk" = (/obj/effect/spawner/lootdrop/raresalvage_spawner,/turf/open/floor/pod/dark,/area/ship_salvage/component/c_3_1)
"bl" = (/obj/effect/spawner/lootdrop/raresalvage_spawner,/turf/open/floor/pod/dark,/area/ship_salvage/component/c_3_2)
"bm" = (/obj/structure/table,/obj/item/weapon/storage/toolbox/mechanical,/turf/open/floor/plasteel/sepia,/area/ship_salvage/component/c_1_3)
"bn" = (/obj/structure/closet/crate/secure/gear,/turf/open/floor/pod/dark,/area/ship_salvage/component/c_3_1)
"bo" = (/obj/structure/lattice/catwalk,/obj/machinery/atmospherics/pipe/simple/general/visible{dir = 5},/turf/open/space,/area/ship_salvage/hull)
"bp" = (/obj/machinery/atmospherics/pipe/simple/general/visible{dir = 4},/turf/closed/wall,/area/ship_salvage/component/c_1_3)
"bq" = (/obj/machinery/atmospherics/pipe/manifold/general/visible{dir = 1},/obj/structure/cable{d1 = 1; d2 = 2; icon_state = "1-2"},/turf/open/floor/plasteel/sepia,/area/ship_salvage/component/c_1_3)
"br" = (/obj/machinery/atmospherics/pipe/simple/general/visible{dir = 4},/obj/effect/spawner/lootdrop/salvage_spawner,/turf/open/floor/plasteel/sepia,/area/ship_salvage/component/c_1_3)
"bs" = (/obj/structure/lattice/catwalk,/obj/machinery/atmospherics/pipe/simple/general/visible{dir = 9},/turf/open/space,/area/ship_salvage/hull)
"bt" = (/obj/vehicle/space/speedbike/red{dir = 1},/turf/open/floor/pod/dark,/area/ship_salvage/component/c_3_2)
"bu" = (/obj/machinery/light/small/built,/turf/open/floor/pod/dark,/area/ship_salvage/component/c_3_2)
"bv" = (/obj/structure/lattice/catwalk,/turf/open/space,/area/ship_salvage/hull)
"bw" = (/turf/closed/wall,/area/ship_salvage/component/c_3_3)
"bx" = (/obj/machinery/atmospherics/pipe/manifold/general/visible{dir = 8},/obj/structure/cable{d1 = 1; d2 = 2; icon_state = "1-2"},/obj/structure/cable{d1 = 1; d2 = 4; icon_state = "1-4"},/turf/open/floor/plasteel/sepia,/area/ship_salvage/component/c_3_3)
"by" = (/obj/machinery/atmospherics/components/unary/portables_connector/visible{dir = 8},/obj/machinery/portable_atmospherics/canister/toxins,/obj/structure/cable{d1 = 2; d2 = 8; icon_state = "2-8"},/turf/open/floor/plasteel/sepia,/area/ship_salvage/component/c_3_3)
"bz" = (/obj/structure/closet/crate/secure/weapon,/obj/machinery/door/window/brigdoor/northleft,/obj/machinery/light/small/built,/turf/open/floor/pod/dark,/area/ship_salvage/component/c_3_1)
"bA" = (/obj/machinery/door/window/brigdoor/northright,/obj/effect/spawner/lootdrop/salvage_spawner,/turf/open/floor/pod/dark,/area/ship_salvage/component/c_3_1)
"bB" = (/obj/machinery/atmospherics/pipe/manifold/general/visible{dir = 8},/obj/machinery/light/built,/obj/structure/cable{d1 = 1; d2 = 2; icon_state = "1-2"},/turf/open/floor/plasteel/sepia,/area/ship_salvage/component/c_3_3)
"bC" = (/turf/closed/wall,/area/ship_salvage/component/c_2_3)
"bD" = (/obj/structure/shuttle/engine/propulsion,/turf/template_noop,/area/ship_salvage/component/c_2_3)

(1,1,1) = {"
aaaaaaaaaaaaaaababababaaaaaaaaaaaaaaaa
aaaaaaaaaaacacadaeafagacacaaaaaaaaaaaa
aaaaaaaaaaabahaiajajaiakabaaaaaaaaaaaa
aaaaaaaaaaacajalaiaiaiajacaaaaaaaaaaaa
aaaaaaaaaaaaamacaianacamaaaaaaaaaaaaaa
aaaaaoaoaoaoapacaqaracapaoaoaoaoaaaaaa
aaaaaoasataoauacavawacauaoasaxaoaaaaaa
aaayaoazaAaBaCaDaEaDaDaCaBazaFaoayaaaa
aGaHaoaoaoaoaCaIaJaKaIaCaoaoaoaoaLaMaa
aNaOaPaPaQaQaRaSaTaUaSaVaQaQaPaPaWaNaa
aXaYaZaZaZaZbaaIaJbbaIbabcbcbcbcaYaXaa
bdaYaZbebfbgbaaDbhaDaDbabibjbkbcaYbdaa
aaaaaZblbfaZbaaDaJbmaDbabcbjbnbcaaaaaa
aaaaaZbfbfaZbobpbqbrbpbsbcbjbjbcaaaaaa
aaaaaZbtbuaZbvbwbxbybwbvbcbzbAbcaaaaaa
aaaaaZaZaZaZaYbwbBbybwaYbcbcbcbcaaaaaa
aaaaaaaaaaaYaYbCaNaNbCaYaYaaaaaaaaaaaa
aaaaaaaaaaaaaaaabDbDaaaaaaaaaaaaaaaaaa
aaaaaaaaaaaaaaaaaaaaaaaaaaaaaaaaaaaaaa
aaaaaaaaaaaaaaaaaaaaaaaaaaaaaaaaaaaaaa
aaaaaaaaaaaaaaaaaaaaaaaaaaaaaaaaaaaaaa
"}
