"aa" = (/turf/template_noop,/area/template_noop)
"ab" = (/obj/structure/grille,/obj/structure/window/reinforced/fulltile,/turf/open/floor/plating,/area/ship_salvage/component/c_2_2)
"ac" = (/turf/closed/wall,/area/ship_salvage/component/c_2_2)
"ad" = (/obj/structure/table,/turf/open/floor/plasteel/sepia,/area/ship_salvage/component/c_2_2)
"ae" = (/obj/machinery/computer,/turf/open/floor/plasteel/sepia,/area/ship_salvage/component/c_2_2)
"af" = (/obj/structure/table,/obj/effect/spawner/lootdrop/gambling,/turf/open/floor/plasteel/sepia,/area/ship_salvage/component/c_2_2)
"ag" = (/turf/open/floor/plasteel/sepia,/area/ship_salvage/component/c_2_2)
"ah" = (/obj/structure/chair{dir = 1},/turf/open/floor/plasteel/sepia,/area/ship_salvage/component/c_2_2)
"ai" = (/obj/machinery/light/built,/turf/open/floor/plasteel/sepia,/area/ship_salvage/component/c_2_2)
"aj" = (/mob/living/simple_animal/hostile/pirate/ranged,/turf/open/floor/plasteel/sepia,/area/ship_salvage/component/c_2_2)
"ak" = (/obj/effect/spawner/lootdrop/salvage_spawner,/turf/open/floor/plasteel/sepia,/area/ship_salvage/component/c_2_2)
"al" = (/turf/closed/wall,/area/ship_salvage/hull)
"am" = (/obj/structure/closet/emcloset,/turf/open/floor/plasteel/sepia,/area/ship_salvage/component/c_2_2)
"an" = (/turf/closed/wall/rust,/area/ship_salvage/component/c_1_1)
"ao" = (/obj/structure/lattice,/obj/machinery/power/smes,/turf/open/space,/area/ship_salvage/hull)
"ap" = (/obj/structure/cable{d1 = 2; d2 = 4; icon_state = "2-4"},/turf/open/floor/plasteel/sepia,/area/ship_salvage/component/c_2_2)
"aq" = (/obj/structure/table,/obj/machinery/microwave,/obj/structure/cable{d2 = 8; icon_state = "0-8"},/turf/open/floor/plasteel/sepia,/area/ship_salvage/component/c_2_2)
"ar" = (/obj/effect/spawner/lootdrop/salvage_spawner,/turf/open/floor/pod/dark,/area/ship_salvage/component/c_1_1)
"as" = (/obj/structure/lattice,/obj/structure/cable{d2 = 2; icon_state = "0-2"},/turf/open/space,/area/ship_salvage/hull)
"at" = (/obj/structure/cable{d1 = 1; d2 = 2; icon_state = "1-2"},/turf/open/floor/plasteel/sepia,/area/ship_salvage/component/c_2_2)
"au" = (/obj/structure/table,/obj/item/weapon/storage/box/donkpockets,/obj/machinery/light/built,/turf/open/floor/plasteel/sepia,/area/ship_salvage/component/c_2_2)
"av" = (/mob/living/simple_animal/hostile/pirate,/turf/open/floor/pod/dark,/area/ship_salvage/component/c_1_1)
"aw" = (/obj/structure/lattice,/obj/machinery/porta_turret/syndicate/pod,/turf/open/space,/area/ship_salvage/component/c_2_1)
"ax" = (/turf/open/floor/pod/dark,/area/ship_salvage/component/c_1_1)
"ay" = (/obj/machinery/light/small/built,/turf/open/floor/pod/dark,/area/ship_salvage/component/c_1_1)
"az" = (/obj/machinery/door/airlock/hatch,/turf/open/floor/pod/dark,/area/ship_salvage/component/c_1_1)
"aA" = (/obj/structure/lattice/catwalk,/obj/structure/cable{d1 = 1; d2 = 2; icon_state = "1-2"},/turf/open/space,/area/ship_salvage/hull)
"aB" = (/turf/closed/wall,/area/ship_salvage/component/c_1_3)
"aC" = (/obj/machinery/door/airlock/external,/turf/open/floor/plasteel/sepia,/area/ship_salvage/component/c_1_3)
"aD" = (/obj/machinery/light/small/built,/obj/machinery/portable_atmospherics/canister/agent_b,/turf/open/floor/pod/dark,/area/ship_salvage/component/c_1_1)
"aE" = (/obj/structure/lattice/catwalk,/obj/machinery/atmospherics/pipe/simple/general/visible{dir = 6},/turf/open/space,/area/ship_salvage/component/c_2_3)
"aF" = (/obj/structure/lattice,/obj/machinery/atmospherics/pipe/simple/general/visible{dir = 10},/turf/open/space,/area/ship_salvage/component/c_2_1)
"aG" = (/obj/structure/grille,/obj/structure/window/reinforced/fulltile,/turf/open/floor/plating,/area/ship_salvage/component/c_1_3)
"aH" = (/obj/structure/cable{d1 = 1; d2 = 2; icon_state = "1-2"},/turf/open/floor/plasteel/sepia,/area/ship_salvage/component/c_1_3)
"aI" = (/obj/machinery/suit_storage_unit/mining/eva,/turf/open/floor/plasteel/sepia,/area/ship_salvage/component/c_1_3)
"aJ" = (/obj/structure/lattice,/obj/machinery/atmospherics/pipe/simple/general/visible{dir = 6},/turf/open/space,/area/ship_salvage/component/c_2_1)
"aK" = (/obj/structure/lattice/catwalk,/obj/machinery/atmospherics/pipe/simple/general/visible{dir = 10},/turf/open/space,/area/ship_salvage/component/c_2_3)
"aL" = (/obj/structure/shuttle/engine/heater,/obj/structure/window/reinforced{dir = 1},/obj/machinery/atmospherics/pipe/simple/general/visible,/turf/closed/wall,/area/ship_salvage/component/c_2_3)
"aM" = (/obj/structure/lattice,/obj/machinery/atmospherics/pipe/simple/general/visible{dir = 5},/obj/structure/cable{d1 = 4; d2 = 8; icon_state = "4-8"},/turf/open/space,/area/ship_salvage/hull)
"aN" = (/obj/structure/lattice,/obj/machinery/atmospherics/pipe/simple/general/visible{dir = 4},/obj/structure/cable{d1 = 4; d2 = 8; icon_state = "4-8"},/turf/open/space,/area/ship_salvage/hull)
"aO" = (/obj/structure/lattice/catwalk,/obj/machinery/atmospherics/pipe/simple/general/visible{dir = 4},/obj/structure/cable{d1 = 4; d2 = 8; icon_state = "4-8"},/turf/open/space,/area/ship_salvage/hull)
"aP" = (/obj/structure/lattice/catwalk,/obj/machinery/atmospherics/pipe/simple/general/visible{dir = 10},/obj/structure/cable{d1 = 1; d2 = 4; icon_state = "1-4"},/obj/structure/cable{d1 = 1; d2 = 8; icon_state = "1-8"},/turf/open/space,/area/ship_salvage/hull)
"aQ" = (/obj/machinery/door/airlock/external{req_access_txt = "150"},/obj/structure/cable{d1 = 4; d2 = 8; icon_state = "4-8"},/turf/open/floor/pod/dark,/area/ship_salvage/component/c_1_3)
"aR" = (/obj/structure/cable{d1 = 4; d2 = 8; icon_state = "4-8"},/obj/structure/cable{d1 = 1; d2 = 8; icon_state = "1-8"},/obj/structure/cable{d1 = 2; d2 = 8; icon_state = "2-8"},/mob/living/simple_animal/hostile/pirate,/turf/open/floor/plasteel/sepia,/area/ship_salvage/component/c_1_3)
"aS" = (/obj/structure/cable{d1 = 4; d2 = 8; icon_state = "4-8"},/turf/open/floor/plasteel/sepia,/area/ship_salvage/component/c_1_3)
"aT" = (/obj/structure/lattice/catwalk,/obj/machinery/atmospherics/pipe/simple/general/visible{dir = 6},/obj/structure/cable{d1 = 1; d2 = 8; icon_state = "1-8"},/obj/structure/cable{d1 = 1; d2 = 4; icon_state = "1-4"},/turf/open/space,/area/ship_salvage/hull)
"aU" = (/obj/structure/lattice,/obj/machinery/atmospherics/pipe/simple/general/visible{dir = 9},/obj/structure/cable{d1 = 4; d2 = 8; icon_state = "4-8"},/turf/open/space,/area/ship_salvage/hull)
"aV" = (/obj/structure/shuttle/engine/propulsion,/obj/structure/lattice/catwalk,/turf/open/space,/area/ship_salvage/component/c_2_3)
"aW" = (/obj/structure/lattice,/turf/open/space,/area/ship_salvage/hull)
"aX" = (/turf/closed/wall/rust,/area/ship_salvage/component/c_3_2)
"aY" = (/obj/structure/lattice/catwalk,/obj/machinery/atmospherics/pipe/simple/general/visible,/turf/open/space,/area/ship_salvage/hull)
"aZ" = (/obj/structure/closet/firecloset,/obj/machinery/light/built,/turf/open/floor/plasteel/sepia,/area/ship_salvage/component/c_1_3)
"ba" = (/turf/closed/wall/rust,/area/ship_salvage/component/c_3_1)
"bb" = (/obj/structure/lattice/catwalk,/turf/open/space,/area/ship_salvage/component/c_2_3)
"bc" = (/obj/effect/spawner/lootdrop/salvage_spawner,/turf/open/floor/pod/dark,/area/ship_salvage/component/c_3_2)
"bd" = (/turf/open/floor/pod/dark,/area/ship_salvage/component/c_3_2)
"be" = (/obj/machinery/door/airlock/hatch,/turf/open/floor/pod/dark,/area/ship_salvage/component/c_3_2)
"bf" = (/obj/machinery/door/airlock/external,/obj/structure/cable{d1 = 1; d2 = 2; icon_state = "1-2"},/turf/open/floor/plasteel/sepia,/area/ship_salvage/component/c_1_3)
"bg" = (/obj/machinery/door/airlock/hatch,/turf/open/floor/pod/dark,/area/ship_salvage/component/c_3_1)
"bh" = (/turf/open/floor/pod/dark,/area/ship_salvage/component/c_3_1)
"bi" = (/mob/living/simple_animal/hostile/pirate,/turf/open/floor/pod/dark,/area/ship_salvage/component/c_3_2)
"bj" = (/obj/structure/table,/obj/item/weapon/storage/toolbox/mechanical,/turf/open/floor/plasteel/sepia,/area/ship_salvage/component/c_1_3)
"bk" = (/obj/structure/lattice/catwalk,/obj/machinery/atmospherics/pipe/simple/general/visible{dir = 5},/turf/open/space,/area/ship_salvage/hull)
"bl" = (/obj/machinery/atmospherics/pipe/simple/general/visible{dir = 4},/turf/closed/wall,/area/ship_salvage/component/c_1_3)
"bm" = (/obj/machinery/atmospherics/pipe/manifold/general/visible{dir = 1},/obj/structure/cable{d1 = 1; d2 = 2; icon_state = "1-2"},/turf/open/floor/plasteel/sepia,/area/ship_salvage/component/c_1_3)
"bn" = (/obj/machinery/atmospherics/pipe/simple/general/visible{dir = 4},/obj/effect/spawner/lootdrop/salvage_spawner,/turf/open/floor/plasteel/sepia,/area/ship_salvage/component/c_1_3)
"bo" = (/obj/structure/lattice/catwalk,/obj/machinery/atmospherics/pipe/simple/general/visible{dir = 9},/turf/open/space,/area/ship_salvage/hull)
"bp" = (/obj/effect/spawner/lootdrop/raresalvage_spawner,/turf/open/floor/pod/dark,/area/ship_salvage/component/c_3_2)
"bq" = (/obj/structure/lattice/catwalk,/turf/open/space,/area/ship_salvage/hull)
"br" = (/turf/closed/wall,/area/ship_salvage/component/c_3_3)
"bs" = (/obj/machinery/atmospherics/pipe/manifold/general/visible{dir = 8},/obj/structure/cable{d1 = 1; d2 = 2; icon_state = "1-2"},/obj/structure/cable{d1 = 1; d2 = 4; icon_state = "1-4"},/turf/open/floor/plasteel/sepia,/area/ship_salvage/component/c_3_3)
"bt" = (/obj/machinery/atmospherics/components/unary/portables_connector/visible{dir = 8},/obj/machinery/portable_atmospherics/canister/toxins,/obj/structure/cable{d1 = 2; d2 = 8; icon_state = "2-8"},/turf/open/floor/plasteel/sepia,/area/ship_salvage/component/c_3_3)
"bu" = (/obj/machinery/door/window/brigdoor/northleft,/obj/machinery/light/small/built,/obj/effect/spawner/lootdrop/raresalvage_spawner,/turf/open/floor/pod/dark,/area/ship_salvage/component/c_3_1)
"bv" = (/obj/machinery/door/window/brigdoor/northright,/obj/effect/spawner/lootdrop/raresalvage_spawner,/turf/open/floor/pod/dark,/area/ship_salvage/component/c_3_1)
"bw" = (/obj/effect/spawner/lootdrop/salvage_spawner,/turf/open/floor/plasteel/sepia,/area/ship_salvage/component/c_3_3)
"bx" = (/turf/closed/wall,/area/ship_salvage/component/c_2_3)
"by" = (/obj/structure/shuttle/engine/propulsion,/turf/template_noop,/area/ship_salvage/component/c_2_3)

(1,1,1) = {"
aaaaaaaaaaaaaaababababaaaaaaaaaaaaaaaa
aaaaaaaaaaacacadaeaeafacacaaaaaaaaaaaa
aaaaaaaaaaabaeagahahagaeabaaaaaaaaaaaa
aaaaaaaaaaacahaiajagakahacaaaaaaaaaaaa
aaaaaaaaaaaaalacagamacalaaaaaaaaaaaaaa
aaaaananananaoacapaqacaoananananaaaaaa
aaaaanararanasacatauacasanavaranaaaaaa
aaawanaxayazaAaBaCaBaBaAazaxaDanawaaaa
aEaFananananaAaGaHaIaGaAananananaJaKaa
aLaMaNaNaOaOaPaQaRaSaQaTaOaOaNaNaUaLaa
aVaWaXaXaXaXaYaGaHaZaGaYbabababaaWaVaa
bbaWaXbcbdbeaYaBbfaBaBaYbgbhbhbaaWbbaa
aaaaaXbdbiaXaYaBaHbjaBaYbabhbhbaaaaaaa
aaaaaXbdbdaXbkblbmbnblbobabhbhbaaaaaaa
aaaaaXbpbcaXbqbrbsbtbrbqbabubvbaaaaaaa
aaaaaXaXaXaXaWbrbwbtbraWbabababaaaaaaa
aaaaaaaaaaaWaWbxaLaLbxaWaWaaaaaaaaaaaa
aaaaaaaaaaaaaaaabybyaaaaaaaaaaaaaaaaaa
aaaaaaaaaaaaaaaaaaaaaaaaaaaaaaaaaaaaaa
aaaaaaaaaaaaaaaaaaaaaaaaaaaaaaaaaaaaaa
aaaaaaaaaaaaaaaaaaaaaaaaaaaaaaaaaaaaaa
"}
