//MAP CONVERTED BY dmm2tgm.py THIS HEADER COMMENT PREVENTS RECONVERSION, DO NOT REMOVE 
"aa" = (
/turf/template_noop,
/area/template_noop)
"ab" = (
/obj/structure/lattice,
/turf/open/space,
/area/ship_salvage/hull)
"ac" = (
/obj/structure/grille,
/obj/structure/window/reinforced/fulltile,
/turf/open/floor/plating,
/area/ship_salvage/hull)
"ad" = (
/obj/machinery/computer,
/turf/open/floor/plasteel/redyellow,
/area/ship_salvage/component/c_2_1)
"ag" = (
/obj/structure/chair{
	dir = 1
	},
/turf/open/floor/plasteel/redyellow,
/area/ship_salvage/component/c_2_1)
"al" = (
/obj/structure/lattice,
/turf/open/space,
/area/ship_salvage/component/c_1_1)
"am" = (
/turf/closed/wall,
/area/ship_salvage/hull)
"ao" = (
/turf/closed/wall,
/area/ship_salvage/component/c_2_1)
"ap" = (
/obj/structure/lattice,
/turf/open/space,
/area/ship_salvage/component/c_3_1)
"aq" = (
/obj/machinery/power/shipweapon{
	dir = 1
	},
/obj/structure/cable{
	icon_state = "0-2";
	d2 = 2
	},
/turf/open/floor/plating/airless/warnplate/side,
/area/ship_salvage/component/c_1_1)
"ar" = (
/obj/structure/table,
/turf/open/floor/plasteel/darkbrown,
/area/ship_salvage/component/c_2_2)
"as" = (
/obj/structure/table,
/obj/item/weapon/storage/toolbox/electrical,
/turf/open/floor/plasteel/darkbrown,
/area/ship_salvage/component/c_2_2)
"au" = (
/turf/closed/wall,
/area/ship_salvage/component/c_2_2)
"aw" = (
/obj/structure/cable{
	crit_fail = 0;
	d1 = 4;
	d2 = 8;
	icon_state = "4-8"
	},
/turf/open/floor/plasteel/darkbrown,
/area/ship_salvage/hull)
"ay" = (
/obj/machinery/power/shipweapon{
	dir = 1
	},
/obj/structure/cable{
	icon_state = "0-2";
	d2 = 2
	},
/turf/open/floor/plating/airless/warnplate/side,
/area/ship_salvage/component/c_3_1)
"az" = (
/obj/structure/lattice/catwalk,
/turf/open/space,
/area/ship_salvage/component/c_1_1)
"aA" = (
/obj/structure/lattice/catwalk,
/obj/structure/cable{
	d1 = 1;
	d2 = 2;
	icon_state = "1-2"
	},
/turf/open/space,
/area/ship_salvage/component/c_1_1)
"aH" = (
/obj/structure/lattice/catwalk,
/turf/open/space,
/area/ship_salvage/component/c_3_1)
"aI" = (
/obj/structure/lattice/catwalk,
/obj/structure/cable{
	d1 = 1;
	d2 = 2;
	icon_state = "1-2"
	},
/turf/open/space,
/area/ship_salvage/component/c_3_1)
"aJ" = (
/obj/structure/cable{
	d1 = 1;
	d2 = 2;
	icon_state = "1-2"
	},
/turf/closed/wall,
/area/ship_salvage/hull)
"aM" = (
/obj/structure/bed,
/obj/item/weapon/bedsheet/orange,
/obj/effect/spawner/lootdrop/gambling,
/turf/open/floor/plasteel/darkbrown,
/area/ship_salvage/hull)
"aQ" = (
/obj/structure/bed,
/obj/item/weapon/bedsheet/orange,
/turf/open/floor/plasteel/darkbrown,
/area/ship_salvage/hull)
"aT" = (
/turf/closed/wall,
/area/ship_salvage/component/c_1_2)
"aV" = (
/turf/open/floor/plasteel/warning{
	tag = "icon-plasteel_warn (NORTH)";
	icon_state = "plasteel_warn";
	dir = 1
	},
/area/ship_salvage/component/c_2_2)
"aW" = (
/turf/open/floor/plasteel/warning{
	tag = "icon-plasteel_warn (NORTHEAST)";
	icon_state = "plasteel_warn";
	dir = 5
	},
/area/ship_salvage/component/c_2_2)
"aX" = (
/turf/closed/wall,
/area/ship_salvage/component/c_3_2)
"bc" = (
/obj/machinery/door/airlock/hatch,
/obj/structure/cable{
	crit_fail = 0;
	d1 = 4;
	d2 = 8;
	icon_state = "4-8"
	},
/turf/open/floor/plasteel/darkbrown,
/area/ship_salvage/component/c_1_2)
"bd" = (
/obj/structure/cable{
	d1 = 1;
	d2 = 8;
	icon_state = "1-8"
	},
/turf/open/floor/plasteel/darkbrown,
/area/ship_salvage/component/c_2_2)
"bf" = (
/turf/open/indestructible,
/area/ship_salvage/component/c_2_2)
"bg" = (
/turf/open/floor/plasteel/warning{
	dir = 5
	},
/area/ship_salvage/component/c_2_2)
"bi" = (
/obj/effect/spawner/lootdrop/raresalvage_spawner,
/turf/open/floor/plasteel/warning{
	dir = 5
	},
/area/ship_salvage/hull)
"bj" = (
/obj/structure/cable{
	d1 = 1;
	d2 = 4;
	icon_state = "1-4"
	},
/mob/living/simple_animal/hostile/russian/ranged/trooper,
/turf/open/floor/plasteel/darkbrown,
/area/ship_salvage/hull)
"bk" = (
/obj/machinery/door/airlock/hatch,
/obj/structure/cable{
	crit_fail = 0;
	d1 = 4;
	d2 = 8;
	icon_state = "4-8"
	},
/turf/open/floor/plasteel/darkbrown,
/area/ship_salvage/component/c_3_2)
"bn" = (
/obj/machinery/atmospherics/pipe/simple/general/visible{
	dir = 6
	},
/turf/closed/wall,
/area/ship_salvage/hull)
"bA" = (
/obj/machinery/atmospherics/pipe/simple/general/visible{
	dir = 10
	},
/turf/closed/wall,
/area/ship_salvage/hull)
"bB" = (
/obj/structure/shuttle/engine/heater,
/obj/machinery/atmospherics/pipe/simple/general/visible,
/turf/closed/wall,
/area/ship_salvage/component/c_1_2)
"bD" = (
/obj/machinery/door/poddoor{
	id = "Supermatter doors"
	},
/turf/closed/wall,
/area/ship_salvage/hull)
"bE" = (
/obj/structure/shuttle/engine/heater,
/obj/machinery/atmospherics/pipe/simple/general/visible,
/turf/closed/wall,
/area/ship_salvage/component/c_3_2)
"bF" = (
/obj/structure/shuttle/engine/propulsion,
/turf/template_noop,
/area/ship_salvage/component/c_1_2)
"bH" = (
/turf/open/floor/plasteel/stairs,
/area/ship_salvage/hull)
"bI" = (
/obj/structure/shuttle/engine/propulsion,
/turf/template_noop,
/area/ship_salvage/component/c_3_2)
"bJ" = (
/obj/effect/spawner/lootdrop/salvage_spawner,
/turf/open/floor/plasteel/darkbrown,
/area/ship_salvage/component/c_2_2)
"cj" = (
/obj/machinery/atmospherics/components/unary/portables_connector,
/obj/machinery/portable_atmospherics/canister/toxins,
/obj/structure/cable{
	crit_fail = 0;
	d1 = 4;
	d2 = 8;
	icon_state = "4-8"
	},
/turf/open/floor/plasteel/delivery,
/area/ship_salvage/component/c_2_2)
"cB" = (
/obj/structure/table,
/obj/item/weapon/storage/box/donkpockets,
/obj/structure/cable{
	crit_fail = 0;
	d1 = 4;
	d2 = 8;
	icon_state = "4-8"
	},
/turf/open/floor/plasteel/darkbrown,
/area/ship_salvage/hull)
"dG" = (
/obj/machinery/power/port_gen/pacman/super,
/obj/machinery/atmospherics/pipe/manifold/general/visible{
	dir = 1
	},
/obj/structure/cable{
	d2 = 8;
	icon_state = "0-8"
	},
/obj/structure/cable{
	crit_fail = 0;
	d1 = 4;
	d2 = 8;
	icon_state = "4-8"
	},
/turf/open/floor/plasteel/redyellow,
/area/ship_salvage/component/c_3_2)
"ff" = (
/obj/structure/cable{
	d1 = 1;
	d2 = 8;
	icon_state = "1-8"
	},
/mob/living/simple_animal/hostile/russian/ranged/officer,
/turf/open/floor/plasteel/redyellow,
/area/ship_salvage/component/c_3_2)
"jl" = (
/obj/machinery/portable_atmospherics/canister/air,
/turf/open/floor/plasteel/redyellow,
/area/ship_salvage/component/c_1_2)
"kw" = (
/mob/living/simple_animal/hostile/russian,
/turf/open/floor/plasteel/redyellow,
/area/ship_salvage/component/c_2_1)
"lm" = (
/obj/structure/table,
/obj/item/weapon/storage/firstaid/tactical,
/obj/structure/cable{
	crit_fail = 0;
	d1 = 4;
	d2 = 8;
	icon_state = "4-8"
	},
/turf/open/floor/plasteel/darkbrown,
/area/ship_salvage/component/c_2_2)
"lp" = (
/obj/machinery/atmospherics/pipe/manifold/general/visible{
	dir = 1
	},
/obj/structure/cable{
	crit_fail = 0;
	d1 = 4;
	d2 = 8;
	icon_state = "4-8"
	},
/turf/closed/wall,
/area/ship_salvage/component/c_3_2)
"mx" = (
/turf/open/floor/plasteel/darkbrown,
/area/ship_salvage/hull)
"ne" = (
/obj/machinery/door/airlock/glass_external,
/turf/open/floor/plasteel/darkbrown,
/area/ship_salvage/hull)
"rh" = (
/obj/structure/cable{
	d1 = 1;
	d2 = 2;
	icon_state = "1-2";
	pixel_y = 0
	},
/turf/open/floor/plasteel/darkbrown,
/area/ship_salvage/hull)
"rZ" = (
/obj/structure/cable{
	d1 = 1;
	d2 = 2;
	icon_state = "1-2";
	pixel_y = 0
	},
/turf/open/floor/plasteel/redyellow,
/area/ship_salvage/component/c_1_2)
"tp" = (
/obj/machinery/porta_turret/ai{
	dir = 8
	},
/turf/open/floor/plating/airless/warnplate/end,
/area/ship_salvage/hull)
"vc" = (
/obj/vehicle/atv/turret,
/obj/structure/cable{
	crit_fail = 0;
	d1 = 4;
	d2 = 8;
	icon_state = "4-8"
	},
/mob/living/simple_animal/hostile/bear/Hudson,
/turf/open/floor/plasteel/warning{
	dir = 10
	},
/area/ship_salvage/hull)
"vG" = (
/obj/machinery/atmospherics/pipe/simple/general/visible{
	dir = 6
	},
/obj/structure/cable{
	crit_fail = 0;
	d1 = 4;
	d2 = 8;
	icon_state = "4-8"
	},
/turf/closed/wall,
/area/ship_salvage/hull)
"wv" = (
/obj/machinery/ftl_shieldgen{
	icon_state = "shield_gen_off";
	on = 0
	},
/obj/machinery/atmospherics/pipe/simple/general/visible{
	dir = 9
	},
/obj/structure/cable{
	crit_fail = 0;
	d1 = 4;
	d2 = 8;
	icon_state = "4-8"
	},
/turf/open/floor/plasteel/warning,
/area/ship_salvage/component/c_2_2)
"yc" = (
/obj/machinery/power/terminal{
	dir = 8
	},
/obj/structure/cable{
	d2 = 2;
	icon_state = "0-2";
	pixel_y = 0
	},
/turf/open/floor/plasteel/darkbrown,
/area/ship_salvage/component/c_2_2)
"AC" = (
/obj/effect/spawner/lootdrop/salvage_spawner,
/turf/open/floor/plasteel/redyellow,
/area/ship_salvage/component/c_3_2)
"BZ" = (
/obj/structure/cable{
	d1 = 1;
	d2 = 2;
	icon_state = "1-2";
	pixel_y = 0
	},
/turf/open/floor/plasteel/darkbrown,
/area/ship_salvage/component/c_2_2)
"CV" = (
/obj/machinery/atmospherics/pipe/simple/general/visible{
	dir = 10
	},
/obj/structure/cable{
	crit_fail = 0;
	d1 = 4;
	d2 = 8;
	icon_state = "4-8"
	},
/turf/closed/wall,
/area/ship_salvage/component/c_1_2)
"DS" = (
/obj/machinery/door/airlock/hatch,
/turf/open/floor/plasteel/darkbrown,
/area/ship_salvage/component/c_2_1)
"DU" = (
/obj/structure/cable{
	d1 = 1;
	d2 = 2;
	icon_state = "1-2";
	pixel_y = 0
	},
/turf/open/floor/plasteel/warning{
	tag = "icon-plasteel_warn (NORTHWEST)";
	icon_state = "plasteel_warn";
	dir = 9
	},
/area/ship_salvage/component/c_2_2)
"Fx" = (
/obj/machinery/power/port_gen/pacman/super,
/obj/machinery/atmospherics/pipe/manifold/general/visible{
	dir = 1
	},
/obj/structure/cable{
	crit_fail = 0;
	d1 = 4;
	d2 = 8;
	icon_state = "4-8"
	},
/obj/structure/cable{
	d2 = 4;
	icon_state = "0-4"
	},
/turf/open/floor/plasteel/redyellow,
/area/ship_salvage/component/c_1_2)
"Gl" = (
/obj/effect/spawner/lootdrop/salvage_spawner,
/turf/open/floor/plasteel/redyellow,
/area/ship_salvage/component/c_1_2)
"Hh" = (
/obj/vehicle/atv,
/obj/structure/cable{
	crit_fail = 0;
	d1 = 4;
	d2 = 8;
	icon_state = "4-8"
	},
/turf/open/floor/plasteel/warning{
	dir = 6
	},
/area/ship_salvage/hull)
"HM" = (
/obj/effect/spawner/lootdrop/salvage_spawner,
/obj/structure/cable{
	crit_fail = 0;
	d1 = 4;
	d2 = 8;
	icon_state = "4-8"
	},
/turf/open/floor/plasteel/darkbrown,
/area/ship_salvage/component/c_2_2)
"IV" = (
/obj/structure/cable{
	d1 = 1;
	d2 = 8;
	icon_state = "1-8"
	},
/obj/structure/cable{
	d1 = 1;
	d2 = 4;
	icon_state = "1-4"
	},
/turf/open/floor/plasteel/darkbrown,
/area/ship_salvage/component/c_2_2)
"JA" = (
/obj/effect/spawner/lootdrop/salvage_spawner,
/turf/open/floor/plasteel/darkbrown,
/area/ship_salvage/hull)
"Km" = (
/obj/structure/cable{
	d1 = 1;
	d2 = 2;
	icon_state = "1-2";
	pixel_y = 0
	},
/obj/structure/cable{
	crit_fail = 0;
	d1 = 4;
	d2 = 8;
	icon_state = "4-8"
	},
/turf/open/floor/plasteel/darkbrown,
/area/ship_salvage/component/c_2_2)
"LD" = (
/mob/living/simple_animal/hostile/russian/ranged/mosin,
/turf/open/floor/plasteel/darkbrown,
/area/ship_salvage/component/c_2_2)
"LE" = (
/obj/structure/bed,
/obj/item/weapon/bedsheet/orange,
/obj/machinery/atmospherics/pipe/manifold/general/visible{
	dir = 1
	},
/obj/structure/cable{
	crit_fail = 0;
	d1 = 4;
	d2 = 8;
	icon_state = "4-8"
	},
/turf/open/floor/plasteel/darkbrown,
/area/ship_salvage/hull)
"Mt" = (
/obj/machinery/power/port_gen/pacman/super,
/obj/machinery/atmospherics/pipe/manifold/general/visible{
	dir = 1
	},
/obj/structure/cable{
	d2 = 4;
	icon_state = "0-4"
	},
/turf/open/floor/plasteel/redyellow,
/area/ship_salvage/component/c_1_2)
"MA" = (
/obj/machinery/door/poddoor{
	id = "Supermatter doors"
	},
/turf/open/space,
/area/ship_salvage/hull)
"Ng" = (
/obj/machinery/power/apc/priority{
	auto_name = 1;
	dir = 8;
	name = "west bump";
	pixel_x = -24
	},
/obj/structure/cable{
	d2 = 4;
	icon_state = "0-4"
	},
/obj/structure/cable{
	d1 = 2;
	d2 = 4;
	icon_state = "2-4"
	},
/turf/open/floor/plasteel/darkbrown,
/area/ship_salvage/component/c_2_2)
"OS" = (
/obj/effect/spawner/lootdrop/raresalvage_spawner,
/turf/open/floor/plasteel/redyellow,
/area/ship_salvage/component/c_3_2)
"QI" = (
/obj/structure/cable{
	d1 = 2;
	d2 = 8;
	icon_state = "2-8";
	tag = ""
	},
/turf/open/floor/plasteel/darkbrown,
/area/ship_salvage/hull)
"SJ" = (
/obj/machinery/power/port_gen/pacman/super,
/obj/machinery/atmospherics/pipe/manifold/general/visible{
	dir = 1
	},
/obj/structure/cable{
	d2 = 8;
	icon_state = "0-8"
	},
/turf/open/floor/plasteel/redyellow,
/area/ship_salvage/component/c_3_2)
"SP" = (
/obj/structure/cable{
	crit_fail = 0;
	d1 = 4;
	d2 = 8;
	icon_state = "4-8"
	},
/turf/open/floor/plasteel/warning{
	dir = 6
	},
/area/ship_salvage/component/c_2_2)
"To" = (
/obj/structure/cable{
	d1 = 1;
	d2 = 4;
	icon_state = "1-4"
	},
/mob/living/simple_animal/hostile/russian/ranged/trooper,
/turf/open/floor/plasteel/redyellow,
/area/ship_salvage/component/c_1_2)
"TI" = (
/turf/open/floor/plasteel/darkbrown,
/area/ship_salvage/component/c_2_2)
"Uo" = (
/obj/machinery/atmospherics/pipe/simple/general/visible{
	dir = 6
	},
/obj/structure/cable{
	crit_fail = 0;
	d1 = 4;
	d2 = 8;
	icon_state = "4-8"
	},
/obj/structure/cable{
	d1 = 1;
	d2 = 8;
	icon_state = "1-8"
	},
/turf/open/floor/plasteel/warning{
	dir = 10
	},
/area/ship_salvage/component/c_2_2)
"VH" = (
/obj/machinery/vending/sustenance,
/obj/machinery/atmospherics/pipe/manifold/general/visible{
	dir = 1
	},
/obj/structure/cable{
	crit_fail = 0;
	d1 = 4;
	d2 = 8;
	icon_state = "4-8"
	},
/turf/open/floor/plasteel/darkbrown,
/area/ship_salvage/hull)
"Wn" = (
/obj/structure/cable{
	d1 = 1;
	d2 = 2;
	icon_state = "1-2";
	pixel_y = 0
	},
/turf/open/floor/plasteel/warning{
	tag = "icon-plasteel_warn (WEST)";
	icon_state = "plasteel_warn";
	dir = 8
	},
/area/ship_salvage/component/c_2_2)
"Wq" = (
/obj/structure/cable{
	crit_fail = 0;
	d1 = 4;
	d2 = 8;
	icon_state = "4-8"
	},
/turf/closed/wall,
/area/ship_salvage/component/c_2_2)
"WI" = (
/obj/vehicle/atv,
/turf/open/floor/plasteel/warning{
	dir = 9
	},
/area/ship_salvage/hull)
"WV" = (
/obj/structure/table,
/obj/item/weapon/storage/firstaid,
/obj/effect/spawner/lootdrop/gambling,
/obj/structure/cable{
	icon_state = "0-4";
	d2 = 4
	},
/turf/open/floor/plasteel/redyellow,
/area/ship_salvage/component/c_2_1)
"Xz" = (
/obj/structure/cable{
	crit_fail = 0;
	d1 = 4;
	d2 = 8;
	icon_state = "4-8"
	},
/turf/closed/wall,
/area/ship_salvage/hull)
"Yg" = (
/obj/structure/cable{
	d1 = 1;
	d2 = 2;
	icon_state = "1-2"
	},
/turf/open/floor/plasteel/redyellow,
/area/ship_salvage/component/c_3_2)
"Zf" = (
/obj/machinery/power/smes{
	dir = 4
	},
/obj/structure/cable{
	d2 = 2;
	icon_state = "0-2"
	},
/obj/structure/cable{
	d2 = 2;
	icon_state = "0-2";
	pixel_y = 0
	},
/turf/open/floor/plasteel/darkbrown,
/area/ship_salvage/component/c_2_2)

(1,1,1) = {"
aa
aa
aa
aa
aa
aa
aa
am
am
ac
bn
bB
bF
aa
aa
aa
"}
(2,1,1) = {"
aa
aa
aa
aa
aa
aa
az
am
Gl
jl
Mt
bB
bF
aa
aa
aa
"}
(3,1,1) = {"
aa
aa
aa
aa
al
aq
aA
aJ
rZ
To
Fx
bB
bF
aa
aa
aa
"}
(4,1,1) = {"
aa
aa
aa
aa
aa
aa
az
am
aT
bc
CV
bB
bF
aa
aa
aa
"}
(5,1,1) = {"
aa
aa
aa
aa
aa
aa
am
Ng
BZ
bd
cj
bB
bF
aa
aa
aa
"}
(6,1,1) = {"
ab
ab
ab
aa
aa
ac
Zf
IV
TI
bJ
cj
bB
bF
aa
aa
aa
"}
(7,1,1) = {"
aa
ab
aa
aa
am
ar
yc
Km
DU
Wn
Uo
bB
bF
aa
aa
aa
"}
(8,1,1) = {"
ac
ac
ac
ac
am
as
TI
HM
aV
bf
wv
am
aa
aa
aa
aa
"}
(9,1,1) = {"
ac
ad
ag
kw
DS
TI
LD
lm
aW
bg
SP
am
tp
aa
aa
aa
"}
(10,1,1) = {"
ac
ad
ag
WV
ao
au
au
Wq
au
au
Wq
am
aa
aa
aa
aa
"}
(11,1,1) = {"
ac
ad
ag
kw
DS
mx
ne
aw
ne
WI
vc
MA
bH
aa
aa
aa
"}
(12,1,1) = {"
ac
ac
ac
ac
am
mx
am
Xz
am
bi
Hh
bD
bH
aa
aa
aa
"}
(13,1,1) = {"
aa
ab
aa
aa
am
mx
JA
cB
am
am
vG
bE
bI
aa
aa
aa
"}
(14,1,1) = {"
ab
ab
ab
aa
aa
ac
mx
QI
rh
bj
VH
bE
bI
aa
aa
aa
"}
(15,1,1) = {"
aa
aa
aa
aa
aa
aa
am
aM
aQ
aw
LE
bE
bI
aa
aa
aa
"}
(16,1,1) = {"
aa
aa
aa
aa
aa
aa
aH
am
aX
bk
lp
bE
bI
aa
aa
aa
"}
(17,1,1) = {"
aa
aa
aa
aa
ap
ay
aI
aJ
Yg
ff
dG
bE
bI
aa
aa
aa
"}
(18,1,1) = {"
aa
aa
aa
aa
aa
aa
aH
am
OS
AC
SJ
bE
bI
aa
aa
aa
"}
(19,1,1) = {"
aa
aa
aa
aa
aa
aa
aa
am
am
ac
bA
bE
bI
aa
aa
aa
"}
