"aa" = (/turf/template_noop,/area/template_noop)
"ab" = (/obj/structure/lattice,/turf/open/space,/area/ship_salvage/hull)
"ac" = (/obj/structure/grille,/obj/structure/window/reinforced/fulltile,/turf/open/floor/plating,/area/ship_salvage/hull)
"ad" = (/obj/machinery/computer,/turf/open/floor/plasteel/redyellow,/area/ship_salvage/component/c_2_1)
"ae" = (/obj/structure/chair{dir = 1},/turf/open/floor/plasteel/redyellow,/area/ship_salvage/component/c_2_1)
"af" = (/obj/structure/chair{dir = 1},/obj/structure/cable{d1 = 1; d2 = 2; icon_state = "1-2"},/turf/open/floor/plasteel/redyellow,/area/ship_salvage/component/c_2_1)
"ag" = (/obj/structure/cable{d1 = 2; d2 = 4; icon_state = "2-4"},/mob/living/simple_animal/hostile/russian,/turf/open/floor/plasteel/redyellow,/area/ship_salvage/component/c_2_1)
"ah" = (/obj/structure/table,/obj/item/weapon/storage/firstaid,/obj/structure/cable{crit_fail = 0; d1 = 4; d2 = 8; icon_state = "4-8"},/obj/structure/cable{d1 = 1; d2 = 4; icon_state = "1-4"},/obj/effect/spawner/lootdrop/gambling,/turf/open/floor/plasteel/redyellow,/area/ship_salvage/component/c_2_1)
"ai" = (/obj/structure/cable{d1 = 2; d2 = 8; icon_state = "2-8"},/mob/living/simple_animal/hostile/russian,/turf/open/floor/plasteel/redyellow,/area/ship_salvage/component/c_2_1)
"aj" = (/obj/structure/lattice,/turf/open/space,/area/ship_salvage/component/c_1_1)
"ak" = (/turf/closed/wall,/area/ship_salvage/hull)
"al" = (/obj/machinery/door/airlock/hatch,/obj/structure/cable{d1 = 1; d2 = 2; icon_state = "1-2"},/turf/open/floor/plasteel/darkbrown,/area/ship_salvage/component/c_2_1)
"am" = (/turf/closed/wall,/area/ship_salvage/component/c_2_1)
"an" = (/obj/structure/lattice,/turf/open/space,/area/ship_salvage/component/c_3_1)
"ao" = (/obj/machinery/power/shipweapon{dir = 1},/obj/structure/cable{icon_state = "0-2"; d2 = 2},/turf/open/floor/plating/airless/warnplate/side,/area/ship_salvage/component/c_1_1)
"ap" = (/obj/structure/table,/turf/open/floor/plasteel/darkbrown,/area/ship_salvage/component/c_2_2)
"aq" = (/obj/structure/table,/obj/item/weapon/storage/toolbox/electrical,/turf/open/floor/plasteel/darkbrown,/area/ship_salvage/component/c_2_2)
"ar" = (/obj/structure/cable{d1 = 1; d2 = 2; icon_state = "1-2"},/turf/open/floor/plasteel/darkbrown,/area/ship_salvage/component/c_2_2)
"as" = (/turf/closed/wall,/area/ship_salvage/component/c_2_2)
"at" = (/obj/structure/cable{d1 = 1; d2 = 4; icon_state = "1-4"},/obj/structure/cable{d1 = 2; d2 = 4; icon_state = "2-4"},/turf/open/floor/plasteel/darkbrown,/area/ship_salvage/hull)
"au" = (/obj/structure/cable{crit_fail = 0; d1 = 4; d2 = 8; icon_state = "4-8"},/turf/open/floor/plasteel/darkbrown,/area/ship_salvage/hull)
"av" = (/obj/structure/cable{d1 = 2; d2 = 8; icon_state = "2-8"},/turf/open/floor/plasteel/darkbrown,/area/ship_salvage/hull)
"aw" = (/obj/machinery/power/shipweapon{dir = 1},/obj/structure/cable{icon_state = "0-2"; d2 = 2},/turf/open/floor/plating/airless/warnplate/side,/area/ship_salvage/component/c_3_1)
"ax" = (/obj/structure/lattice/catwalk,/turf/open/space,/area/ship_salvage/component/c_1_1)
"ay" = (/obj/structure/lattice/catwalk,/obj/structure/cable{d1 = 1; d2 = 2; icon_state = "1-2"},/turf/open/space,/area/ship_salvage/component/c_1_1)
"az" = (/obj/machinery/vending/plasmaresearch,/turf/open/floor/plasteel/darkbrown,/area/ship_salvage/component/c_2_2)
"aA" = (/obj/structure/cable{d1 = 2; d2 = 4; icon_state = "2-4"},/turf/open/floor/plasteel/darkbrown,/area/ship_salvage/component/c_2_2)
"aB" = (/obj/structure/cable{crit_fail = 0; d1 = 4; d2 = 8; icon_state = "4-8"},/turf/open/floor/plasteel/darkbrown,/area/ship_salvage/component/c_2_2)
"aC" = (/obj/structure/cable{d1 = 1; d2 = 8; icon_state = "1-8"},/mob/living/simple_animal/hostile/russian/ranged/mosin,/turf/open/floor/plasteel/darkbrown,/area/ship_salvage/component/c_2_2)
"aD" = (/obj/machinery/door/airlock/glass_external,/obj/structure/cable{d1 = 1; d2 = 2; icon_state = "1-2"},/turf/open/floor/plasteel/darkbrown,/area/ship_salvage/hull)
"aE" = (/obj/effect/spawner/lootdrop/salvage_spawner,/turf/open/floor/plasteel/darkbrown,/area/ship_salvage/hull)
"aF" = (/obj/structure/lattice/catwalk,/turf/open/space,/area/ship_salvage/component/c_3_1)
"aG" = (/obj/structure/lattice/catwalk,/obj/structure/cable{d1 = 1; d2 = 2; icon_state = "1-2"},/turf/open/space,/area/ship_salvage/component/c_3_1)
"aH" = (/obj/structure/cable{d1 = 1; d2 = 2; icon_state = "1-2"},/turf/closed/wall,/area/ship_salvage/hull)
"aI" = (/obj/machinery/vending/liberationstation,/turf/open/floor/plasteel/darkbrown,/area/ship_salvage/component/c_2_2)
"aJ" = (/turf/open/floor/plasteel/darkbrown,/area/ship_salvage/component/c_2_2)
"aK" = (/obj/effect/spawner/lootdrop/salvage_spawner,/turf/open/floor/plasteel/darkbrown,/area/ship_salvage/component/c_2_2)
"aL" = (/obj/structure/table,/obj/item/weapon/storage/firstaid/tactical,/turf/open/floor/plasteel/darkbrown,/area/ship_salvage/component/c_2_2)
"aM" = (/obj/structure/cable{d1 = 1; d2 = 2; icon_state = "1-2"},/turf/open/floor/plasteel/darkbrown,/area/ship_salvage/hull)
"aN" = (/obj/structure/table,/obj/item/weapon/storage/box/donkpockets,/turf/open/floor/plasteel/darkbrown,/area/ship_salvage/hull)
"aO" = (/obj/structure/bed,/obj/item/weapon/bedsheet/orange,/obj/effect/spawner/lootdrop/gambling,/turf/open/floor/plasteel/darkbrown,/area/ship_salvage/hull)
"aP" = (/obj/effect/spawner/lootdrop/salvage_spawner,/turf/open/floor/plasteel/redyellow,/area/ship_salvage/component/c_1_2)
"aQ" = (/obj/structure/cable{d1 = 1; d2 = 2; icon_state = "1-2"},/turf/open/floor/plasteel/redyellow,/area/ship_salvage/component/c_1_2)
"aR" = (/turf/closed/wall,/area/ship_salvage/component/c_1_2)
"aS" = (/obj/structure/cable,/obj/structure/cable{d1 = 1; d2 = 8; icon_state = "1-8"},/turf/open/floor/plasteel/warning{tag = "icon-plasteel_warn (NORTHWEST)"; icon_state = "plasteel_warn"; dir = 9},/area/ship_salvage/component/c_2_2)
"aT" = (/turf/open/floor/plasteel/warning{tag = "icon-plasteel_warn (NORTH)"; icon_state = "plasteel_warn"; dir = 1},/area/ship_salvage/component/c_2_2)
"aU" = (/turf/open/floor/plasteel/warning{tag = "icon-plasteel_warn (NORTHEAST)"; icon_state = "plasteel_warn"; dir = 5},/area/ship_salvage/component/c_2_2)
"aV" = (/obj/structure/bed,/obj/item/weapon/bedsheet/orange,/turf/open/floor/plasteel/darkbrown,/area/ship_salvage/hull)
"aW" = (/turf/closed/wall,/area/ship_salvage/component/c_3_2)
"aX" = (/obj/structure/cable{d1 = 1; d2 = 2; icon_state = "1-2"},/turf/open/floor/plasteel/redyellow,/area/ship_salvage/component/c_3_2)
"aY" = (/obj/effect/spawner/lootdrop/raresalvage_spawner,/turf/open/floor/plasteel/redyellow,/area/ship_salvage/component/c_3_2)
"aZ" = (/obj/machinery/portable_atmospherics/canister/air,/obj/structure/cable{d1 = 2; d2 = 4; icon_state = "2-4"},/turf/open/floor/plasteel/redyellow,/area/ship_salvage/component/c_1_2)
"ba" = (/obj/structure/cable{d1 = 2; d2 = 4; icon_state = "2-4"},/obj/structure/cable{crit_fail = 0; d1 = 4; d2 = 8; icon_state = "4-8"},/obj/structure/cable{d1 = 1; d2 = 8; icon_state = "1-8"},/mob/living/simple_animal/hostile/russian/ranged/trooper,/turf/open/floor/plasteel/redyellow,/area/ship_salvage/component/c_1_2)
"bb" = (/obj/machinery/door/airlock/hatch,/obj/structure/cable{crit_fail = 0; d1 = 4; d2 = 8; icon_state = "4-8"},/turf/open/floor/plasteel/darkbrown,/area/ship_salvage/component/c_1_2)
"bc" = (/obj/structure/cable{d1 = 1; d2 = 8; icon_state = "1-8"},/turf/open/floor/plasteel/darkbrown,/area/ship_salvage/component/c_2_2)
"bd" = (/turf/open/floor/plasteel/warning{tag = "icon-plasteel_warn (WEST)"; icon_state = "plasteel_warn"; dir = 8},/area/ship_salvage/component/c_2_2)
"be" = (/turf/open/indestructible,/area/ship_salvage/component/c_2_2)
"bf" = (/turf/open/floor/plasteel/warning{dir = 5},/area/ship_salvage/component/c_2_2)
"bg" = (/obj/structure/cable{d1 = 1; d2 = 2; icon_state = "1-2"},/obj/vehicle/atv,/turf/open/floor/plasteel/warning{dir = 9},/area/ship_salvage/hull)
"bh" = (/obj/effect/spawner/lootdrop/raresalvage_spawner,/turf/open/floor/plasteel/warning{dir = 5},/area/ship_salvage/hull)
"bi" = (/obj/structure/cable{d1 = 1; d2 = 4; icon_state = "1-4"},/mob/living/simple_animal/hostile/russian/ranged/trooper,/turf/open/floor/plasteel/darkbrown,/area/ship_salvage/hull)
"bj" = (/obj/machinery/door/airlock/hatch,/obj/structure/cable{crit_fail = 0; d1 = 4; d2 = 8; icon_state = "4-8"},/turf/open/floor/plasteel/darkbrown,/area/ship_salvage/component/c_3_2)
"bk" = (/obj/structure/cable{d1 = 2; d2 = 8; icon_state = "2-8"},/obj/structure/cable{crit_fail = 0; d1 = 4; d2 = 8; icon_state = "4-8"},/obj/structure/cable{d1 = 1; d2 = 4; icon_state = "1-4"},/mob/living/simple_animal/hostile/russian/ranged/officer,/turf/open/floor/plasteel/redyellow,/area/ship_salvage/component/c_3_2)
"bl" = (/obj/effect/spawner/lootdrop/salvage_spawner,/turf/open/floor/plasteel/redyellow,/area/ship_salvage/component/c_3_2)
"bm" = (/obj/machinery/atmospherics/pipe/simple/general/visible{dir = 6},/turf/closed/wall,/area/ship_salvage/hull)
"bn" = (/obj/machinery/power/port_gen/pacman/super,/obj/machinery/atmospherics/pipe/manifold/general/visible{dir = 1},/obj/structure/cable,/turf/open/floor/plasteel/redyellow,/area/ship_salvage/component/c_1_2)
"bo" = (/obj/machinery/atmospherics/pipe/simple/general/visible{dir = 10},/turf/closed/wall,/area/ship_salvage/component/c_1_2)
"bp" = (/obj/machinery/atmospherics/components/unary/portables_connector,/obj/machinery/portable_atmospherics/canister/toxins,/turf/open/floor/plasteel/delivery,/area/ship_salvage/component/c_2_2)
"bq" = (/obj/machinery/atmospherics/pipe/simple/general/visible{dir = 6},/turf/open/floor/plasteel/warning{dir = 10},/area/ship_salvage/component/c_2_2)
"br" = (/obj/machinery/ftl_shieldgen,/obj/machinery/atmospherics/pipe/simple/general/visible{dir = 9},/turf/open/floor/plasteel/warning,/area/ship_salvage/component/c_2_2)
"bs" = (/turf/open/floor/plasteel/warning{dir = 6},/area/ship_salvage/component/c_2_2)
"bt" = (/obj/vehicle/atv/turret,/obj/structure/cable{d1 = 1; d2 = 2; icon_state = "1-2"},/mob/living/simple_animal/hostile/bear/Hudson,/turf/open/floor/plasteel/warning{dir = 10},/area/ship_salvage/hull)
"bu" = (/obj/vehicle/atv,/turf/open/floor/plasteel/warning{dir = 6},/area/ship_salvage/hull)
"bv" = (/obj/machinery/vending/sustenance,/obj/machinery/atmospherics/pipe/manifold/general/visible{dir = 1},/turf/open/floor/plasteel/darkbrown,/area/ship_salvage/hull)
"bw" = (/obj/structure/bed,/obj/item/weapon/bedsheet/orange,/obj/machinery/atmospherics/pipe/manifold/general/visible{dir = 1},/turf/open/floor/plasteel/darkbrown,/area/ship_salvage/hull)
"bx" = (/obj/machinery/atmospherics/pipe/manifold/general/visible{dir = 1},/turf/closed/wall,/area/ship_salvage/component/c_3_2)
"by" = (/obj/machinery/power/port_gen/pacman/super,/obj/machinery/atmospherics/pipe/manifold/general/visible{dir = 1},/obj/structure/cable,/turf/open/floor/plasteel/redyellow,/area/ship_salvage/component/c_3_2)
"bz" = (/obj/machinery/atmospherics/pipe/simple/general/visible{dir = 10},/turf/closed/wall,/area/ship_salvage/hull)
"bA" = (/obj/structure/shuttle/engine/heater,/obj/machinery/atmospherics/pipe/simple/general/visible,/turf/closed/wall,/area/ship_salvage/component/c_1_2)
"bB" = (/obj/machinery/door/poddoor{id = "Supermatter doors"},/obj/structure/cable{d1 = 1; d2 = 2; icon_state = "1-2"},/turf/open/space,/area/ship_salvage/hull)
"bC" = (/obj/machinery/door/poddoor{id = "Supermatter doors"},/turf/closed/wall,/area/ship_salvage/hull)
"bD" = (/obj/structure/shuttle/engine/heater,/obj/machinery/atmospherics/pipe/simple/general/visible,/turf/closed/wall,/area/ship_salvage/component/c_3_2)
"bE" = (/obj/structure/shuttle/engine/propulsion,/turf/template_noop,/area/ship_salvage/component/c_1_2)
"bF" = (/obj/machinery/porta_turret/syndicate/vehicle_turret,/turf/open/floor/plating/airless/warnplate/end,/area/ship_salvage/hull)
"bG" = (/turf/open/floor/plasteel/stairs,/area/ship_salvage/hull)
"bH" = (/obj/structure/shuttle/engine/propulsion,/turf/template_noop,/area/ship_salvage/component/c_3_2)

(1,1,1) = {"
aaaaaaaaaaabaaacacacacacaaabaaaaaaaaaa
aaaaaaaaaaababacadadadacababaaaaaaaaaa
aaaaaaaaaaabaaacaeafaeacaaabaaaaaaaaaa
aaaaaaaaaaaaaaacagahaiacaaaaaaaaaaaaaa
aaaaajaaaaaaakakalamalakakaaaaaaanaaaa
aaaaaoaaaaacapaqarasatauavacaaaaawaaaa
aaaxayaxakazaAaBaCasaDakaEavakaFaGaFaa
akakaHakaIaJaraKaLasaMakaNaMaOakaHakak
akaPaQaRaAaBaSaTaUasaDakakaMaVaWaXaYak
acaZbabbbcaKbdbebfasbgbhakbiaubjbkblac
bmbnbnbobpbpbqbrbsasbtbubmbvbwbxbybybz
bAbAbAbAbAbAbAakakakbBbCbDbDbDbDbDbDbD
bEbEbEbEbEbEbEaabFaabGbGbHbHbHbHbHbHbH
aaaaaaaaaaaaaaaaaaaaaaaaaaaaaaaaaaaaaa
aaaaaaaaaaaaaaaaaaaaaaaaaaaaaaaaaaaaaa
aaaaaaaaaaaaaaaaaaaaaaaaaaaaaaaaaaaaaa
"}
